PWKEY	PREDATOR	PREY	CODE
ACA_SPP-ACA_SPP	ACARTIA_SPP	ACARTIA_SPP	2
ACA_SPP-AUT_FLA	ACARTIA_SPP	AUTOTHROPH_FLAGELLAT	1
ACA_SPP-DIATOM	ACARTIA_SPP	DIATOM	1
ACA_SPP-HET_FLA	ACARTIA_SPP	HETEROTROPH_FLAGELLAT	1
ACA_SPP-MIX_FLA	ACARTIA_SPP	MIXOTROPH_FLAGELLATES	4
ACA_SPP-PROZOO	ACARTIA_SPP	PROTOZOOPLANKTON	1
ACT_G_SP-AUT_FLA	ACTINIARIA_G_SP	AUTOTHROPH_FLAGELLAT	4
ACT_G_SP-DIATOM	ACTINIARIA_G_SP	DIATOM	4
ACT_G_SP-GAM_IND	ACTINIARIA_G_SP	GAMMARIDAE_INDET	1
ACT_G_SP-HET_FLA	ACTINIARIA_G_SP	HETEROTROPH_FLAGELLAT	4
ACT_G_SP-MAC_IND	ACTINIARIA_G_SP	MACROALGAE	1
ACT_G_SP-POL_IND	ACTINIARIA_G_SP	POLYCHAETA	1
AGL_DIG-CAL_FIN	AGLANTHA_DIGITALE	CALANUS_FINMARCHICUS	1
AGL_DIG-OIT_SIM	AGLANTHA_DIGITALE	OITHONA_SPINIROSTRIS/ATLANTICA	1
AGL_DIG-ONC_BOR	AGLANTHA_DIGITALE	ONCAEA_BOREALIS	4
AGL_MAL-LUM_MIN	AGLAOPHAMUS_MALMGRENI	LUMBRICLYMENE_MINOR	3
AGL_MAL-LUM_SP	AGLAOPHAMUS_MALMGRENI	LUMBRINERIS_SP	3
AGL_MAL-POL_IND	AGLAOPHAMUS_MALMGRENI	POLYCHAETA	1
AGL_MAL-POLY_IND	AGLAOPHAMUS_MALMGRENI	POLYNOIDAE_INDET	3
AGO_CAT-CHL_ISL	AGONUS_CATAPHRACTUS	CHLAMYS_ISLANDICA	1
AGO_CAT-GAM_IND	AGONUS_CATAPHRACTUS	GAMMARIDAE_INDET	1
AGO_CAT-OPH_ACU	AGONUS_CATAPHRACTUS	OPHIOPHOLIS_ACULEATA	4
AGO_CAT-OPH_BID	AGONUS_CATAPHRACTUS	OPHIACANTHA_BIDENTATA	4
AGO_CAT-OPH_SER	AGONUS_CATAPHRACTUS	OPHIOCTEN_SERICEUM	4
AGO_CAT-OPH_SP	AGONUS_CATAPHRACTUS	OPHIURA_SP	1
AGO_CAT-OST_IND	AGONUS_CATAPHRACTUS	OSTRACODA_INDET	1
AGO_CAT-PAG_SP	AGONUS_CATAPHRACTUS	PAGURUS_SP	4
AGO_CAT-POL_IND	AGONUS_CATAPHRACTUS	POLYCHAETA	1
AGO_CAT-THE_ABY	AGONUS_CATAPHRACTUS	THEMISTO_ABYSSORUM	4
AGO_CAT-THE_LIB	AGONUS_CATAPHRACTUS	THEMISTO_LIBELLULA	4
AGO_CAT-THY_INE	AGONUS_CATAPHRACTUS	THYSANOESSA_INERMIS	4
AGO_CAT-THY_LON	AGONUS_CATAPHRACTUS	THYSANOESSA_LONGICAUDATA	4
ALL_ALL-ACA_SPP	ALLE_ALLE	ACARTIA_SPP	1
ALL_ALL-APH_GLA	ALLE_ALLE	APHERUSA_GLACIALIS	1
ALL_ALL-BEN_LAR	ALLE_ALLE	BENTHOS_LARVAE	1
ALL_ALL-CAL_FIN	ALLE_ALLE	CALANUS_FINMARCHICUS	1
ALL_ALL-CAL_GLA	ALLE_ALLE	CALANUS_GLACIALIS	1
ALL_ALL-CAL_HYP	ALLE_ALLE	CALANUS_HYPERBOREUS	1
ALL_ALL-CLI_LIM	ALLE_ALLE	CLIONE_LIMACINA	1
ALL_ALL-FI_LA	ALLE_ALLE	FISH_LARVAE	1
ALL_ALL-FRI_BOR	ALLE_ALLE	FRITILLARIA_BOREALIS	1
ALL_ALL-GAM_WIL	ALLE_ALLE	GAMMARUS_WILKITZKII	1
ALL_ALL-LIM_HEL	ALLE_ALLE	LIMACINA_HELICINA	1
ALL_ALL-LIM_RET	ALLE_ALLE	LIMACINA_RETROVERSA	1
ALL_ALL-MEG_NOR	ALLE_ALLE	MEGANYCTIPHANES_NORVEGICA	2
ALL_ALL-MET_LON	ALLE_ALLE	METRIDIA_LONGA	1
ALL_ALL-MIC_SPP	ALLE_ALLE	MICROCALANUS_SPP	1
ALL_ALL-OIK_DIO	ALLE_ALLE	OIKOPLEURA_DIOICA	4
ALL_ALL-OIK_SPP	ALLE_ALLE	OIKOPLEURA_SPP	1
ALL_ALL-OIK_VAN	ALLE_ALLE	OIKOPLEURA_VANHOEFFENI	4
ALL_ALL-OIT_SIM	ALLE_ALLE	OITHONA_SPINIROSTRIS/ATLANTICA	1
ALL_ALL-OIT_SPI	ALLE_ALLE	OITHONA_SIMILIS	1
ALL_ALL-ONC_BOR	ALLE_ALLE	ONCAEA_BOREALIS	1
ALL_ALL-OST_IND	ALLE_ALLE	OSTRACODA_INDET	1
ALL_ALL-PAR_NOR	ALLE_ALLE	PAREUCHAETA_NORVEGICA	1
ALL_ALL-PAR_SPP	ALLE_ALLE	PAREUCHAETA_SPP	1
ALL_ALL-PSE_SPP	ALLE_ALLE	PSEUDOCALANUS_SPP	1
ALL_ALL-SAB_SP	ALLE_ALLE	SABINEA_SP	1
ALL_ALL-SAG_SPP	ALLE_ALLE	SAGITTA_SPP	1
ALL_ALL-THE_ABY	ALLE_ALLE	THEMISTO_ABYSSORUM	1
ALL_ALL-THE_LIB	ALLE_ALLE	THEMISTO_LIBELLULA	1
ALL_ALL-THY_INE	ALLE_ALLE	THYSANOESSA_INERMIS	1
ALL_ALL-THY_LON	ALLE_ALLE	THYSANOESSA_LONGICAUDATA	1
ALL_ALL-THY_RAS	ALLE_ALLE	THYSANOESSA_RASCHII	1
AMB_HYP-ARC_RIS	AMBLYRAJA_HYPERBOREA	ARCTOZENUS_RISSO	4
AMB_HYP-CLU_HAR	AMBLYRAJA_HYPERBOREA	CLUPEA_HARENGUS	1
AMB_HYP-COT_MIC	AMBLYRAJA_HYPERBOREA	COTTUNCULUS_MICROPS	4
AMB_HYP-FOR_IND	AMBLYRAJA_HYPERBOREA	FORAMINIFERA	1
AMB_HYP-GAD_MOR	AMBLYRAJA_HYPERBOREA	GADUS_MORHUA	1
AMB_HYP-HIP_PLA	AMBLYRAJA_HYPERBOREA	HIPPOGLOSSOIDES_PLATESSOIDES	1
AMB_HYP-LYC_ESM	AMBLYRAJA_HYPERBOREA	LYCODES_ESMARKII	4
AMB_HYP-LYC_EUD	AMBLYRAJA_HYPERBOREA	LYCODES_EUDIPLEUROSTICTUS	4
AMB_HYP-LYC_GRA	AMBLYRAJA_HYPERBOREA	LYCODES_GRACILIS	4
AMB_HYP-LYC_KOL	AMBLYRAJA_HYPERBOREA	LYCENCHELYS_KOLTHOFFI	4
AMB_HYP-LYC_PAL	AMBLYRAJA_HYPERBOREA	LYCODES_PALLIDUS	4
AMB_HYP-LYC_RET	AMBLYRAJA_HYPERBOREA	LYCODES_RETICULATUS	4
AMB_HYP-LYC_ROS	AMBLYRAJA_HYPERBOREA	LYCODES_ROSSI	4
AMB_HYP-LYC_SEM	AMBLYRAJA_HYPERBOREA	LYCODES_SEMINUDUS	4
AMB_HYP-MAC_BER	AMBLYRAJA_HYPERBOREA	MACROURUS_BERGLAX	1
AMB_HYP-MAL_VIL	AMBLYRAJA_HYPERBOREA	MALLOTUS_VILLOSUS	1
AMB_HYP-MEL_AEG	AMBLYRAJA_HYPERBOREA	MELANOGRAMMUS_AEGLEFINUS	1
AMB_HYP-MIC_POU	AMBLYRAJA_HYPERBOREA	MICROMESISTIUS_POUTASSOU	1
AMB_HYP-PAN_BOR	AMBLYRAJA_HYPERBOREA	PANDALUS_BOREALIS	1
AMB_HYP-POL_IND	AMBLYRAJA_HYPERBOREA	POLYCHAETA	1
AMB_HYP-REI_HIP	AMBLYRAJA_HYPERBOREA	REINHARDTIUS_HIPPOGLOSSOIDES	1
AMB_HYP-ROS_SP	AMBLYRAJA_HYPERBOREA	ROSSIA_SP	4
AMB_HYP-SEB_MAR	AMBLYRAJA_HYPERBOREA	SEBASTES_MARINUS	1
AMB_HYP-SEB_MEN	AMBLYRAJA_HYPERBOREA	SEBASTES_MENTELLA	1
AMB_HYP-SEB_SPP	AMBLYRAJA_HYPERBOREA	SEBASTES_SPP	1
AMB_HYP-THE_ABY	AMBLYRAJA_HYPERBOREA	THEMISTO_ABYSSORUM	4
AMB_HYP-THE_LIB	AMBLYRAJA_HYPERBOREA	THEMISTO_LIBELLULA	1
AMB_HYP-THY_INE	AMBLYRAJA_HYPERBOREA	THYSANOESSA_INERMIS	4
AMB_HYP-THY_LON	AMBLYRAJA_HYPERBOREA	THYSANOESSA_LONGICAUDATA	4
AMB_RAD-AMB_RAD	AMBLYRAJA_RADIATA	AMBLYRAJA_RADIATA	1
AMB_RAD-AMM_SPP	AMBLYRAJA_RADIATA	AMMODYTES_SPP	1
AMB_RAD-ANA_DEN	AMBLYRAJA_RADIATA	ANARHICHAS_DENTICULATUS	4
AMB_RAD-ANA_LUP	AMBLYRAJA_RADIATA	ANARHICHAS_LUPUS	4
AMB_RAD-ANA_MIN	AMBLYRAJA_RADIATA	ANARHICHAS_MINOR	1
AMB_RAD-ARC_RIS	AMBLYRAJA_RADIATA	ARCTOZENUS_RISSO	4
AMB_RAD-ARR_PHY	AMBLYRAJA_RADIATA	ARRHIS_PHYLLONYX	1
AMB_RAD-ART_ATL	AMBLYRAJA_RADIATA	ARTEDIELLUS_ATLANTICUS	1
AMB_RAD-BOR_SAI	AMBLYRAJA_RADIATA	BOREOGADUS_SAIDA	1
AMB_RAD-BRO_BRO	AMBLYRAJA_RADIATA	BROSME_BROSME	1
AMB_RAD-CHI_OPI	AMBLYRAJA_RADIATA	CHIONOECETES_OPILIO	1
AMB_RAD-CLU_HAR	AMBLYRAJA_RADIATA	CLUPEA_HARENGUS	1
AMB_RAD-COT_MIC	AMBLYRAJA_RADIATA	COTTUNCULUS_MICROPS	4
AMB_RAD-CUC_FRO	AMBLYRAJA_RADIATA	CUCUMARIA_FRONDOSA	1
AMB_RAD-ELE_ARC	AMBLYRAJA_RADIATA	ELECTRA_ARCTICA	1
AMB_RAD-EUP_FLAM	AMBLYRAJA_RADIATA	EUPHYSA_FLAMMEA	4
AMB_RAD-GAD_MOR	AMBLYRAJA_RADIATA	GADUS_MORHUA	1
AMB_RAD-GAM_IND	AMBLYRAJA_RADIATA	GAMMARIDAE_INDET	1
AMB_RAD-GLY_CYN	AMBLYRAJA_RADIATA	GLYPTOCEPHALUS_CYNOGLOSSUS	1
AMB_RAD-GON_FAB	AMBLYRAJA_RADIATA	GONATUS_FABRICII	1
AMB_RAD-HIP_PLA	AMBLYRAJA_RADIATA	HIPPOGLOSSOIDES_PLATESSOIDES	1
AMB_RAD-HYA_SP	AMBLYRAJA_RADIATA	HYAS_SP	1
AMB_RAD-LEP_DEC	AMBLYRAJA_RADIATA	LEPTAGONUS_DECAGONUS	1
AMB_RAD-LIP_FAB	AMBLYRAJA_RADIATA	LIPARIS_FABRICII	1
AMB_RAD-LIP_GIB	AMBLYRAJA_RADIATA	LIPARIS_GIBBUS	1
AMB_RAD-LIP_MON	AMBLYRAJA_RADIATA	LIPARIS_MONTAGUI	1
AMB_RAD-LUM_LAM	AMBLYRAJA_RADIATA	LUMPENUS_LAMPRETAEFORMIS	1
AMB_RAD-LUM_SP	AMBLYRAJA_RADIATA	LUMBRINERIS_SP	4
AMB_RAD-LYC_ESM	AMBLYRAJA_RADIATA	LYCODES_ESMARKII	1
AMB_RAD-MAC_BER	AMBLYRAJA_RADIATA	MACROURUS_BERGLAX	1
AMB_RAD-MAL_VIL	AMBLYRAJA_RADIATA	MALLOTUS_VILLOSUS	1
AMB_RAD-MEG_NOR	AMBLYRAJA_RADIATA	MEGANYCTIPHANES_NORVEGICA	1
AMB_RAD-MEL_AEG	AMBLYRAJA_RADIATA	MELANOGRAMMUS_AEGLEFINUS	1
AMB_RAD-MER_MER	AMBLYRAJA_RADIATA	MERLANGIUS_MERLANGUS	1
AMB_RAD-MET_LON	AMBLYRAJA_RADIATA	METRIDIA_LONGA	1
AMB_RAD-MIC_POU	AMBLYRAJA_RADIATA	MICROMESISTIUS_POUTASSOU	1
AMB_RAD-OPH_SP	AMBLYRAJA_RADIATA	OPHIURA_SP	1
AMB_RAD-PAG_SP	AMBLYRAJA_RADIATA	PAGURUS_SP	1
AMB_RAD-PAN_BOR	AMBLYRAJA_RADIATA	PANDALUS_BOREALIS	1
AMB_RAD-PAR_CAM	AMBLYRAJA_RADIATA	PARALITHODES_CAMTSCHATICUS	2
AMB_RAD-POL_IND	AMBLYRAJA_RADIATA	POLYCHAETA	1
AMB_RAD-POL_VIR	AMBLYRAJA_RADIATA	POLLACHIUS_VIRENS	1
AMB_RAD-PON_NOR	AMBLYRAJA_RADIATA	PONTOPHILUS_NORVEGICUS	1
AMB_RAD-PYC_G_SP	AMBLYRAJA_RADIATA	PYCNOGONIDA_G_SP	1
AMB_RAD-REI_HIP	AMBLYRAJA_RADIATA	REINHARDTIUS_HIPPOGLOSSOIDES	1
AMB_RAD-RHA_SP	AMBLYRAJA_RADIATA	RHACHOTROPIS_SP	1
AMB_RAD-ROS_SP	AMBLYRAJA_RADIATA	ROSSIA_SP	1
AMB_RAD-SAB_SP	AMBLYRAJA_RADIATA	SABINEA_SP	1
AMB_RAD-SEB_MAR	AMBLYRAJA_RADIATA	SEBASTES_MARINUS	1
AMB_RAD-SEB_MEN	AMBLYRAJA_RADIATA	SEBASTES_MENTELLA	1
AMB_RAD-SEB_SPP	AMBLYRAJA_RADIATA	SEBASTES_SPP	1
AMB_RAD-THE_ABY	AMBLYRAJA_RADIATA	THEMISTO_ABYSSORUM	1
AMB_RAD-THE_LIB	AMBLYRAJA_RADIATA	THEMISTO_LIBELLULA	4
AMB_RAD-THY_INE	AMBLYRAJA_RADIATA	THYSANOESSA_INERMIS	1
AMB_RAD-THY_LON	AMBLYRAJA_RADIATA	THYSANOESSA_LONGICAUDATA	1
AMB_RAD-THY_RAS	AMBLYRAJA_RADIATA	THYSANOESSA_RASCHII	1
AMB_RAD-TRI_ESM	AMBLYRAJA_RADIATA	TRISOPTERUS_ESMARKII	1
AMB_RAD-TRI_MUR	AMBLYRAJA_RADIATA	TRIGLOPS_MURRAYI	1
AMB_RAD-TRI_NYB	AMBLYRAJA_RADIATA	TRIGLOPS_NYBELINI	1
AMB_RAD-ULC_OLR	AMBLYRAJA_RADIATA	ULCINA_OLRIKII	1
AMM_SPP-ACA_SPP	AMMODYTES_SPP	ACARTIA_SPP	4
AMM_SPP-CAL_FIN	AMMODYTES_SPP	CALANUS_FINMARCHICUS	2
AMM_SPP-CAL_GLA	AMMODYTES_SPP	CALANUS_GLACIALIS	2
AMM_SPP-CAL_HYP	AMMODYTES_SPP	CALANUS_HYPERBOREUS	2
AMM_SPP-FI_LA	AMMODYTES_SPP	FISH_LARVAE	4
AMM_SPP-MET_LON	AMMODYTES_SPP	METRIDIA_LONGA	4
AMM_SPP-MET_LUC	AMMODYTES_SPP	METRIDIA_LUCENS	2
AMM_SPP-MIC_SPP	AMMODYTES_SPP	MICROCALANUS_SPP	4
AMM_SPP-OIK_SPP	AMMODYTES_SPP	OIKOPLEURA_SPP	4
AMM_SPP-OIT_SIM	AMMODYTES_SPP	OITHONA_SPINIROSTRIS/ATLANTICA	2
AMM_SPP-ONC_BOR	AMMODYTES_SPP	ONCAEA_BOREALIS	4
AMM_SPP-PSE_SPP	AMMODYTES_SPP	PSEUDOCALANUS_SPP	4
AMM_SPP-SAG_SPP	AMMODYTES_SPP	SAGITTA_SPP	4
AMM_SPP-THE_ABY	AMMODYTES_SPP	THEMISTO_ABYSSORUM	4
AMM_SPP-THY_LON	AMMODYTES_SPP	THYSANOESSA_LONGICAUDATA	4
ANA_DEN-ANA_LUP	ANARHICHAS_DENTICULATUS	ANARHICHAS_LUPUS	1
ANA_DEN-AUR_AUR	ANARHICHAS_DENTICULATUS	AURELIA_AURITA	1
ANA_DEN-BER_SP	ANARHICHAS_DENTICULATUS	BEROè_SP	1
ANA_DEN-BOL_INF	ANARHICHAS_DENTICULATUS	BOLINOPSIS_INFUNDIBULUM	1
ANA_DEN-CAL_FIN	ANARHICHAS_DENTICULATUS	CALANUS_FINMARCHICUS	2
ANA_DEN-CAL_GLA	ANARHICHAS_DENTICULATUS	CALANUS_GLACIALIS	2
ANA_DEN-CAL_HYP	ANARHICHAS_DENTICULATUS	CALANUS_HYPERBOREUS	2
ANA_DEN-CTE_CRI	ANARHICHAS_DENTICULATUS	CTENODISCUS_CRISPATUS	1
ANA_DEN-EUP_FLAM	ANARHICHAS_DENTICULATUS	EUPHYSA_FLAMMEA	2
ANA_DEN-GOR_SP	ANARHICHAS_DENTICULATUS	GORGONOCEPHALUS_SP	1
ANA_DEN-MEL_AEG	ANARHICHAS_DENTICULATUS	MELANOGRAMMUS_AEGLEFINUS	3
ANA_DEN-MER_OVU	ANARHICHAS_DENTICULATUS	MERTENSIA_OVUM	2
ANA_DEN-MIC_POU	ANARHICHAS_DENTICULATUS	MICROMESISTIUS_POUTASSOU	1
ANA_DEN-OPH_BID	ANARHICHAS_DENTICULATUS	OPHIACANTHA_BIDENTATA	1
ANA_DEN-OPH_SP	ANARHICHAS_DENTICULATUS	OPHIURA_SP	1
ANA_DEN-PAG_SP	ANARHICHAS_DENTICULATUS	PAGURUS_SP	1
ANA_DEN-PAN_BOR	ANARHICHAS_DENTICULATUS	PANDALUS_BOREALIS	1
ANA_DEN-POL_IND	ANARHICHAS_DENTICULATUS	POLYCHAETA	1
ANA_DEN-SAB_SP	ANARHICHAS_DENTICULATUS	SABINEA_SP	2
ANA_DEN-SAG_SPP	ANARHICHAS_DENTICULATUS	SAGITTA_SPP	4
ANA_DEN-SEB_SPP	ANARHICHAS_DENTICULATUS	SEBASTES_SPP	1
ANA_LUP-ASC_G_SP	ANARHICHAS_LUPUS	ASCIDIACEA_G_SP	1
ANA_LUP-AST_SP	ANARHICHAS_LUPUS	ASTARTE_SP	1
ANA_LUP-BAL_SP	ANARHICHAS_LUPUS	BALANUS_SP	1
ANA_LUP-BRY_IND	ANARHICHAS_LUPUS	BRYOZOA_INDET	3
ANA_LUP-BUC_SP	ANARHICHAS_LUPUS	BUCCINUM_SP	1
ANA_LUP-CAL_FIN	ANARHICHAS_LUPUS	CALANUS_FINMARCHICUS	2
ANA_LUP-CAL_GLA	ANARHICHAS_LUPUS	CALANUS_GLACIALIS	2
ANA_LUP-CAL_HYP	ANARHICHAS_LUPUS	CALANUS_HYPERBOREUS	2
ANA_LUP-CHL_ISL	ANARHICHAS_LUPUS	CHLAMYS_ISLANDICA	1
ANA_LUP-COL_SP	ANARHICHAS_LUPUS	COLUS_SP	1
ANA_LUP-CTE_CRI	ANARHICHAS_LUPUS	CTENODISCUS_CRISPATUS	1
ANA_LUP-FI_LA	ANARHICHAS_LUPUS	FISH_LARVAE	1
ANA_LUP-GAD_MOR	ANARHICHAS_LUPUS	GADUS_MORHUA	1
ANA_LUP-MAC_SP	ANARHICHAS_LUPUS	MACOMA_SP	1
ANA_LUP-MEG_NOR	ANARHICHAS_LUPUS	MEGANYCTIPHANES_NORVEGICA	2
ANA_LUP-OPH_BID	ANARHICHAS_LUPUS	OPHIACANTHA_BIDENTATA	1
ANA_LUP-OPH_SP	ANARHICHAS_LUPUS	OPHIURA_SP	1
ANA_LUP-PAG_SP	ANARHICHAS_LUPUS	PAGURUS_SP	1
ANA_LUP-PAN_BOR	ANARHICHAS_LUPUS	PANDALUS_BOREALIS	1
ANA_LUP-POL_IND	ANARHICHAS_LUPUS	POLYCHAETA	1
ANA_LUP-PON_NOR	ANARHICHAS_LUPUS	PONTOPHILUS_NORVEGICUS	1
ANA_LUP-POR_G_SP	ANARHICHAS_LUPUS	PORIFERA_G_SP	1
ANA_LUP-SAB_SP	ANARHICHAS_LUPUS	SABINEA_SP	2
ANA_LUP-STRO_SP	ANARHICHAS_LUPUS	STRONGYLOCENTROTUS_SP	1
ANA_LUP-THY_INE	ANARHICHAS_LUPUS	THYSANOESSA_INERMIS	2
ANA_LUP-THY_LON	ANARHICHAS_LUPUS	THYSANOESSA_LONGICAUDATA	2
ANA_LUP-THY_RAS	ANARHICHAS_LUPUS	THYSANOESSA_RASCHII	2
ANA_MIN-BUC_SP	ANARHICHAS_MINOR	BUCCINUM_SP	1
ANA_MIN-CAL_FIN	ANARHICHAS_MINOR	CALANUS_FINMARCHICUS	2
ANA_MIN-CAL_GLA	ANARHICHAS_MINOR	CALANUS_GLACIALIS	2
ANA_MIN-CAL_HYP	ANARHICHAS_MINOR	CALANUS_HYPERBOREUS	2
ANA_MIN-CTE_CRI	ANARHICHAS_MINOR	CTENODISCUS_CRISPATUS	1
ANA_MIN-GAD_MOR	ANARHICHAS_MINOR	GADUS_MORHUA	1
ANA_MIN-MEG_NOR	ANARHICHAS_MINOR	MEGANYCTIPHANES_NORVEGICA	2
ANA_MIN-MEL_AEG	ANARHICHAS_MINOR	MELANOGRAMMUS_AEGLEFINUS	1
ANA_MIN-MIC_POU	ANARHICHAS_MINOR	MICROMESISTIUS_POUTASSOU	1
ANA_MIN-OPH_ACU	ANARHICHAS_MINOR	OPHIOPHOLIS_ACULEATA	1
ANA_MIN-OPH_SP	ANARHICHAS_MINOR	OPHIURA_SP	4
ANA_MIN-PAG_SP	ANARHICHAS_MINOR	PAGURUS_SP	2
ANA_MIN-PAN_BOR	ANARHICHAS_MINOR	PANDALUS_BOREALIS	1
ANA_MIN-POL_IND	ANARHICHAS_MINOR	POLYCHAETA	1
ANA_MIN-POR_G_SP	ANARHICHAS_MINOR	PORIFERA_G_SP	1
ANA_MIN-SAB_SP	ANARHICHAS_MINOR	SABINEA_SP	2
ANA_MIN-SEB_SPP	ANARHICHAS_MINOR	SEBASTES_SPP	1
ANA_MIN-STRO_SP	ANARHICHAS_MINOR	STRONGYLOCENTROTUS_SP	1
ANA_MIN-THY_INE	ANARHICHAS_MINOR	THYSANOESSA_INERMIS	2
ANA_MIN-THY_LON	ANARHICHAS_MINOR	THYSANOESSA_LONGICAUDATA	2
ANA_MIN-THY_RAS	ANARHICHAS_MINOR	THYSANOESSA_RASCHII	2
ANI_MED-CAL_GLA	ANISARCHUS_MEDIUS	CALANUS_GLACIALIS	1
ANI_MED-OIT_SPI	ANISARCHUS_MEDIUS	OITHONA_SIMILIS	4
ANI_MED-ONC_BOR	ANISARCHUS_MEDIUS	ONCAEA_BOREALIS	1
ANI_MED-PSE_SPP	ANISARCHUS_MEDIUS	PSEUDOCALANUS_SPP	1
APH_GLA-BAC_IND	APHERUSA_GLACIALIS	BACTERIA_INDET	1
APH_GLA-DET_IND	APHERUSA_GLACIALIS	DETRITUS	1
APH_GLA-ICE_ALG	APHERUSA_GLACIALIS	ICE_ALGAE	1
APH_GLA-PHY_IND	APHERUSA_GLACIALIS	PHYTOPLANKTON_INDET	1
APH_MAR-DET_IND	APHELOCHAETA_MARIONI	DETRITUS	3
APH_MAR-DIATOM	APHELOCHAETA_MARIONI	DIATOM	1
APH_MAR-FI_LA	APHELOCHAETA_MARIONI	FISH_LARVAE	1
APH_MAR-PHY_IND	APHELOCHAETA_MARIONI	PHYTOPLANKTON_INDET	1
ARC_GLA-CAL_HYP	ARCTOGADUS_GLACIALIS	CALANUS_HYPERBOREUS	1
ARC_GLA-PSE_SPP	ARCTOGADUS_GLACIALIS	PSEUDOCALANUS_SPP	1
ARC_GLA-THE_ABY	ARCTOGADUS_GLACIALIS	THEMISTO_ABYSSORUM	1
ARC_GLA-THE_LIB	ARCTOGADUS_GLACIALIS	THEMISTO_LIBELLULA	1
ARC_RIS-GON_FAB	ARCTOZENUS_RISSO	GONATUS_FABRICII	3
ARG_SP-LUM_SP	ARGENTINA_SP	LUMBRINERIS_SP	4
ARG_SP-MEG_NOR	ARGENTINA_SP	MEGANYCTIPHANES_NORVEGICA	4
ARG_SP-OIK_SPP	ARGENTINA_SP	OIKOPLEURA_SPP	4
ARG_SP-SCA_INF	ARGENTINA_SP	SCALIBREGMA_INFLATUM	4
ARR_PHY-DET_IND	ARRHIS_PHYLLONYX	DETRITUS	1
ART_ATL-GON_FAB	ARTEDIELLUS_ATLANTICUS	GONATUS_FABRICII	2
ART_ATL-MAL_VIL	ARTEDIELLUS_ATLANTICUS	MALLOTUS_VILLOSUS	1
ART_ATL-OPH_SP	ARTEDIELLUS_ATLANTICUS	OPHIURA_SP	3
ART_ATL-POL_IND	ARTEDIELLUS_ATLANTICUS	POLYCHAETA	1
ART_ATL-THE_ABY	ARTEDIELLUS_ATLANTICUS	THEMISTO_ABYSSORUM	2
ART_ATL-THE_LIB	ARTEDIELLUS_ATLANTICUS	THEMISTO_LIBELLULA	2
ASC_G_SP-BAC_IND	ASCIDIACEA_G_SP	BACTERIA_INDET	4
ASC_G_SP-DET_IND	ASCIDIACEA_G_SP	DETRITUS	1
ASC_G_SP-PHY_IND	ASCIDIACEA_G_SP	PHYTOPLANKTON_INDET	1
ASE_IND-AUT_FLA	ASELLOTA_INDET	AUTOTHROPH_FLAGELLAT	1
ASE_IND-DET_IND	ASELLOTA_INDET	DETRITUS	1
ASE_IND-DIATOM	ASELLOTA_INDET	DIATOM	1
ASE_IND-FOR_IND	ASELLOTA_INDET	FORAMINIFERA	1
ASE_IND-HET_FLA	ASELLOTA_INDET	HETEROTROPH_FLAGELLAT	1
ASE_IND-MIX_FLA	ASELLOTA_INDET	MIXOTROPH_FLAGELLATES	4
AST_RUB-AST_RUB	ASTERIAS_RUBENS	ASTERIAS_RUBENS	4
AST_RUB-BAL_SP	ASTERIAS_RUBENS	BALANUS_SP	2
AST_RUB-CRO_PAP	ASTERIAS_RUBENS	CROSSASTER_PAPPOSUS	2
AST_RUB-OPH_ACU	ASTERIAS_RUBENS	OPHIOPHOLIS_ACULEATA	2
AST_RUB-OPH_BID	ASTERIAS_RUBENS	OPHIACANTHA_BIDENTATA	2
AST_RUB-OPH_SP	ASTERIAS_RUBENS	OPHIURA_SP	2
AST_RUB-STRO_SP	ASTERIAS_RUBENS	STRONGYLOCENTROTUS_SP	2
AST_SP-DET_IND	ASTARTE_SP	DETRITUS	4
AST_SP-PHY_IND	ASTARTE_SP	PHYTOPLANKTON_INDET	3
AUR_AUR-CAL_FIN	AURELIA_AURITA	CALANUS_FINMARCHICUS	2
AUR_AUR-CAL_GLA	AURELIA_AURITA	CALANUS_GLACIALIS	2
AUR_AUR-CAL_HYP	AURELIA_AURITA	CALANUS_HYPERBOREUS	2
AUR_AUR-MET_LON	AURELIA_AURITA	METRIDIA_LONGA	2
AUR_AUR-MIC_SPP	AURELIA_AURITA	MICROCALANUS_SPP	2
AUR_AUR-OIT_SIM	AURELIA_AURITA	OITHONA_SPINIROSTRIS/ATLANTICA	2
AUR_AUR-PSE_SPP	AURELIA_AURITA	PSEUDOCALANUS_SPP	4
BAL_ACU-AMM_SPP	BALAENOPTERA_ACUTOROSTRATA	AMMODYTES_SPP	1
BAL_ACU-BEN_GLA	BALAENOPTERA_ACUTOROSTRATA	BENTHOSEMA_GLACIALE	1
BAL_ACU-BOR_SAI	BALAENOPTERA_ACUTOROSTRATA	BOREOGADUS_SAIDA	1
BAL_ACU-CLI_LIM	BALAENOPTERA_ACUTOROSTRATA	CLIONE_LIMACINA	2
BAL_ACU-CLU_HAR	BALAENOPTERA_ACUTOROSTRATA	CLUPEA_HARENGUS	1
BAL_ACU-FI_LA	BALAENOPTERA_ACUTOROSTRATA	FISH_LARVAE	1
BAL_ACU-GAD_MOR	BALAENOPTERA_ACUTOROSTRATA	GADUS_MORHUA	1
BAL_ACU-GLY_CYN	BALAENOPTERA_ACUTOROSTRATA	GLYPTOCEPHALUS_CYNOGLOSSUS	1
BAL_ACU-LYC_ESM	BALAENOPTERA_ACUTOROSTRATA	LYCODES_ESMARKII	4
BAL_ACU-LYC_RET	BALAENOPTERA_ACUTOROSTRATA	LYCODES_RETICULATUS	4
BAL_ACU-LYC_SEM	BALAENOPTERA_ACUTOROSTRATA	LYCODES_SEMINUDUS	4
BAL_ACU-MAL_VIL	BALAENOPTERA_ACUTOROSTRATA	MALLOTUS_VILLOSUS	1
BAL_ACU-MEG_NOR	BALAENOPTERA_ACUTOROSTRATA	MEGANYCTIPHANES_NORVEGICA	1
BAL_ACU-MEL_AEG	BALAENOPTERA_ACUTOROSTRATA	MELANOGRAMMUS_AEGLEFINUS	1
BAL_ACU-MIC_POU	BALAENOPTERA_ACUTOROSTRATA	MICROMESISTIUS_POUTASSOU	1
BAL_ACU-POL_VIR	BALAENOPTERA_ACUTOROSTRATA	POLLACHIUS_VIRENS	1
BAL_ACU-REI_HIP	BALAENOPTERA_ACUTOROSTRATA	REINHARDTIUS_HIPPOGLOSSOIDES	2
BAL_ACU-SCO_SCO	BALAENOPTERA_ACUTOROSTRATA	SCOMBER_SCOMBRUS	4
BAL_ACU-SEB_MEN	BALAENOPTERA_ACUTOROSTRATA	SEBASTES_MENTELLA	2
BAL_ACU-SEB_SPP	BALAENOPTERA_ACUTOROSTRATA	SEBASTES_SPP	1
BAL_ACU-THE_ABY	BALAENOPTERA_ACUTOROSTRATA	THEMISTO_ABYSSORUM	1
BAL_ACU-THE_LIB	BALAENOPTERA_ACUTOROSTRATA	THEMISTO_LIBELLULA	1
BAL_ACU-THY_INE	BALAENOPTERA_ACUTOROSTRATA	THYSANOESSA_INERMIS	1
BAL_ACU-THY_LON	BALAENOPTERA_ACUTOROSTRATA	THYSANOESSA_LONGICAUDATA	1
BAL_ACU-THY_RAS	BALAENOPTERA_ACUTOROSTRATA	THYSANOESSA_RASCHII	1
BAL_PHY-AMM_SPP	BALAENOPTERA_PHYSALUS	AMMODYTES_SPP	4
BAL_PHY-BOR_SAI	BALAENOPTERA_PHYSALUS	BOREOGADUS_SAIDA	1
BAL_PHY-CAL_FIN	BALAENOPTERA_PHYSALUS	CALANUS_FINMARCHICUS	1
BAL_PHY-CAL_GLA	BALAENOPTERA_PHYSALUS	CALANUS_GLACIALIS	1
BAL_PHY-CAL_HYP	BALAENOPTERA_PHYSALUS	CALANUS_HYPERBOREUS	1
BAL_PHY-CLI_LIM	BALAENOPTERA_PHYSALUS	CLIONE_LIMACINA	2
BAL_PHY-CLU_HAR	BALAENOPTERA_PHYSALUS	CLUPEA_HARENGUS	1
BAL_PHY-FI_LA	BALAENOPTERA_PHYSALUS	FISH_LARVAE	1
BAL_PHY-FUL_GLA	BALAENOPTERA_PHYSALUS	FULMARUS_GLACIALIS	1
BAL_PHY-GAD_MOR	BALAENOPTERA_PHYSALUS	GADUS_MORHUA	4
BAL_PHY-GLY_CYN	BALAENOPTERA_PHYSALUS	GLYPTOCEPHALUS_CYNOGLOSSUS	4
BAL_PHY-GON_FAB	BALAENOPTERA_PHYSALUS	GONATUS_FABRICII	1
BAL_PHY-MAL_VIL	BALAENOPTERA_PHYSALUS	MALLOTUS_VILLOSUS	1
BAL_PHY-MEG_NOR	BALAENOPTERA_PHYSALUS	MEGANYCTIPHANES_NORVEGICA	1
BAL_PHY-MEL_AEG	BALAENOPTERA_PHYSALUS	MELANOGRAMMUS_AEGLEFINUS	4
BAL_PHY-MIC_POU	BALAENOPTERA_PHYSALUS	MICROMESISTIUS_POUTASSOU	1
BAL_PHY-POL_VIR	BALAENOPTERA_PHYSALUS	POLLACHIUS_VIRENS	4
BAL_PHY-SCO_SCO	BALAENOPTERA_PHYSALUS	SCOMBER_SCOMBRUS	4
BAL_PHY-SEB_SPP	BALAENOPTERA_PHYSALUS	SEBASTES_SPP	4
BAL_PHY-THE_ABY	BALAENOPTERA_PHYSALUS	THEMISTO_ABYSSORUM	4
BAL_PHY-THE_LIB	BALAENOPTERA_PHYSALUS	THEMISTO_LIBELLULA	4
BAL_PHY-THY_INE	BALAENOPTERA_PHYSALUS	THYSANOESSA_INERMIS	1
BAL_PHY-THY_LON	BALAENOPTERA_PHYSALUS	THYSANOESSA_LONGICAUDATA	1
BAL_PHY-THY_RAS	BALAENOPTERA_PHYSALUS	THYSANOESSA_RASCHII	1
BAL_SP-DET_IND	BALANUS_SP	DETRITUS	2
BAT_GLA-DET_IND	BATHYARCA_GLACIALIS	DETRITUS	4
BAT_SPI-ANA_MIN	BATHYRAJA_SPINICAUDA	ANARHICHAS_MINOR	1
BAT_SPI-GAM_IND	BATHYRAJA_SPINICAUDA	GAMMARIDAE_INDET	1
BAT_SPI-HIP_PLA	BATHYRAJA_SPINICAUDA	HIPPOGLOSSOIDES_PLATESSOIDES	1
BAT_SPI-LUM_LAM	BATHYRAJA_SPINICAUDA	LUMPENUS_LAMPRETAEFORMIS	1
BAT_SPI-MAC_BER	BATHYRAJA_SPINICAUDA	MACROURUS_BERGLAX	1
BAT_SPI-MEG_NOR	BATHYRAJA_SPINICAUDA	MEGANYCTIPHANES_NORVEGICA	1
BAT_SPI-MEL_AEG	BATHYRAJA_SPINICAUDA	MELANOGRAMMUS_AEGLEFINUS	1
BAT_SPI-MIC_POU	BATHYRAJA_SPINICAUDA	MICROMESISTIUS_POUTASSOU	1
BAT_SPI-PAN_BOR	BATHYRAJA_SPINICAUDA	PANDALUS_BOREALIS	1
BAT_SPI-POL_IND	BATHYRAJA_SPINICAUDA	POLYCHAETA	1
BAT_SPI-REI_HIP	BATHYRAJA_SPINICAUDA	REINHARDTIUS_HIPPOGLOSSOIDES	1
BAT_SPI-SEB_MAR	BATHYRAJA_SPINICAUDA	SEBASTES_MARINUS	2
BAT_SPI-SEB_MEN	BATHYRAJA_SPINICAUDA	SEBASTES_MENTELLA	2
BAT_SPI-SEB_SPP	BATHYRAJA_SPINICAUDA	SEBASTES_SPP	1
BAT_SPI-THY_INE	BATHYRAJA_SPINICAUDA	THYSANOESSA_INERMIS	1
BEN_GLA-GAM_IND	BENTHOSEMA_GLACIALE	GAMMARIDAE_INDET	2
BEN_GLA-OST_IND	BENTHOSEMA_GLACIALE	OSTRACODA_INDET	1
BEN_LAR-BAC_IND	BENTHOS_LARVAE	BACTERIA_INDET	4
BEN_LAR-PHY_IND	BENTHOS_LARVAE	PHYTOPLANKTON_INDET	4
BER_SP-ACA_SPP	BEROè_SP	ACARTIA_SPP	1
BER_SP-BAC_IND	BEROè_SP	BACTERIA_INDET	4
BER_SP-BOL_INF	BEROè_SP	BOLINOPSIS_INFUNDIBULUM	1
BER_SP-CAL_FIN	BEROè_SP	CALANUS_FINMARCHICUS	1
BER_SP-MIC_SPP	BEROè_SP	MICROCALANUS_SPP	1
BER_SP-OIT_SIM	BEROè_SP	OITHONA_SPINIROSTRIS/ATLANTICA	1
BER_SP-OIT_SPI	BEROè_SP	OITHONA_SIMILIS	4
BER_SP-ONC_BOR	BEROè_SP	ONCAEA_BOREALIS	4
BER_SP-PSE_SPP	BEROè_SP	PSEUDOCALANUS_SPP	4
BOL_INF-CAL_FIN	BOLINOPSIS_INFUNDIBULUM	CALANUS_FINMARCHICUS	2
BOL_INF-CAL_GLA	BOLINOPSIS_INFUNDIBULUM	CALANUS_GLACIALIS	2
BOL_INF-CAL_HYP	BOLINOPSIS_INFUNDIBULUM	CALANUS_HYPERBOREUS	2
BOL_INF-MET_LON	BOLINOPSIS_INFUNDIBULUM	METRIDIA_LONGA	2
BOL_INF-MIC_SPP	BOLINOPSIS_INFUNDIBULUM	MICROCALANUS_SPP	2
BOL_INF-OIT_SIM	BOLINOPSIS_INFUNDIBULUM	OITHONA_SPINIROSTRIS/ATLANTICA	2
BOL_INF-PSE_SPP	BOLINOPSIS_INFUNDIBULUM	PSEUDOCALANUS_SPP	2
BOR_SAI-ACA_SPP	BOREOGADUS_SAIDA	ACARTIA_SPP	4
BOR_SAI-APH_GLA	BOREOGADUS_SAIDA	APHERUSA_GLACIALIS	1
BOR_SAI-CAL_FIN	BOREOGADUS_SAIDA	CALANUS_FINMARCHICUS	1
BOR_SAI-CAL_GLA	BOREOGADUS_SAIDA	CALANUS_GLACIALIS	4
BOR_SAI-CAL_HYP	BOREOGADUS_SAIDA	CALANUS_HYPERBOREUS	4
BOR_SAI-ERY_SP	BOREOGADUS_SAIDA	ERYTHROPS_SP	4
BOR_SAI-GAM_IND	BOREOGADUS_SAIDA	GAMMARIDAE_INDET	1
BOR_SAI-GAM_WIL	BOREOGADUS_SAIDA	GAMMARUS_WILKITZKII	1
BOR_SAI-LIM_HEL	BOREOGADUS_SAIDA	LIMACINA_HELICINA	4
BOR_SAI-MAL_VIL	BOREOGADUS_SAIDA	MALLOTUS_VILLOSUS	1
BOR_SAI-MEG_NOR	BOREOGADUS_SAIDA	MEGANYCTIPHANES_NORVEGICA	1
BOR_SAI-MET_LON	BOREOGADUS_SAIDA	METRIDIA_LONGA	4
BOR_SAI-MIC_SPP	BOREOGADUS_SAIDA	MICROCALANUS_SPP	4
BOR_SAI-OIK_SPP	BOREOGADUS_SAIDA	OIKOPLEURA_SPP	4
BOR_SAI-OIT_SIM	BOREOGADUS_SAIDA	OITHONA_SPINIROSTRIS/ATLANTICA	4
BOR_SAI-ONI_GLA	BOREOGADUS_SAIDA	ONISIMUS_GLACIALIS	1
BOR_SAI-ONI_NAN	BOREOGADUS_SAIDA	ONISIMUS_NANSENI	1
BOR_SAI-OST_IND	BOREOGADUS_SAIDA	OSTRACODA_INDET	1
BOR_SAI-PAN_BOR	BOREOGADUS_SAIDA	PANDALUS_BOREALIS	4
BOR_SAI-PAR_GLA	BOREOGADUS_SAIDA	PAREUCHAETA_GLACIALIS	4
BOR_SAI-PAR_NOR	BOREOGADUS_SAIDA	PAREUCHAETA_NORVEGICA	4
BOR_SAI-POL_IND	BOREOGADUS_SAIDA	POLYCHAETA	4
BOR_SAI-PON_NOR	BOREOGADUS_SAIDA	PONTOPHILUS_NORVEGICUS	4
BOR_SAI-PSE_SPP	BOREOGADUS_SAIDA	PSEUDOCALANUS_SPP	4
BOR_SAI-SAB_SP	BOREOGADUS_SAIDA	SABINEA_SP	4
BOR_SAI-SAG_SPP	BOREOGADUS_SAIDA	SAGITTA_SPP	4
BOR_SAI-SPI_TYP	BOREOGADUS_SAIDA	SPIOCHAETOPTERUS_TYPICUS	4
BOR_SAI-THE_ABY	BOREOGADUS_SAIDA	THEMISTO_ABYSSORUM	4
BOR_SAI-THE_LIB	BOREOGADUS_SAIDA	THEMISTO_LIBELLULA	1
BOR_SAI-THY_INE	BOREOGADUS_SAIDA	THYSANOESSA_INERMIS	2
BOR_SAI-THY_LON	BOREOGADUS_SAIDA	THYSANOESSA_LONGICAUDATA	2
BOR_SAI-THY_RAS	BOREOGADUS_SAIDA	THYSANOESSA_RASCHII	2
BRO_BRO-ARR_PHY	BROSME_BROSME	ARRHIS_PHYLLONYX	4
BRO_BRO-GAM_IND	BROSME_BROSME	GAMMARIDAE_INDET	2
BRO_BRO-MAU_MUE	BROSME_BROSME	MAUROLICUS_MUELLERI	4
BRO_BRO-MIC_POU	BROSME_BROSME	MICROMESISTIUS_POUTASSOU	4
BRO_BRO-PAN_BOR	BROSME_BROSME	PANDALUS_BOREALIS	4
BRO_BRO-RHA_SP	BROSME_BROSME	RHACHOTROPIS_SP	4
BRO_BRO-SEB_MAR	BROSME_BROSME	SEBASTES_MARINUS	2
BRO_BRO-SEB_MEN	BROSME_BROSME	SEBASTES_MENTELLA	2
BRO_BRO-SEB_SPP	BROSME_BROSME	SEBASTES_SPP	2
BRY_IND-DET_IND	BRYOZOA_INDET	DETRITUS	4
BRY_IND-PHY_IND	BRYOZOA_INDET	PHYTOPLANKTON_INDET	4
BUC_SP-DET_IND	BUCCINUM_SP	DETRITUS	4
CAL_FIN-AUT_FLA	CALANUS_FINMARCHICUS	AUTOTHROPH_FLAGELLAT	2
CAL_FIN-BEN_LAR	CALANUS_FINMARCHICUS	BENTHOS_LARVAE	2
CAL_FIN-CAL_FIN	CALANUS_FINMARCHICUS	CALANUS_FINMARCHICUS	1
CAL_FIN-DET_IND	CALANUS_FINMARCHICUS	DETRITUS	2
CAL_FIN-DIATOM	CALANUS_FINMARCHICUS	DIATOM	4
CAL_FIN-FOR_IND	CALANUS_FINMARCHICUS	FORAMINIFERA	3
CAL_FIN-HET_FLA	CALANUS_FINMARCHICUS	HETEROTROPH_FLAGELLAT	1
CAL_FIN-PHY_IND	CALANUS_FINMARCHICUS	PHYTOPLANKTON_INDET	1
CAL_FIN-PROZOO	CALANUS_FINMARCHICUS	PROTOZOOPLANKTON	2
CAL_GLA-DIATOM	CALANUS_GLACIALIS	DIATOM	4
CAL_GLA-FOR_IND	CALANUS_GLACIALIS	FORAMINIFERA	3
CAL_GLA-PHY_IND	CALANUS_GLACIALIS	PHYTOPLANKTON_INDET	4
CAL_GLA-PROZOO	CALANUS_GLACIALIS	PROTOZOOPLANKTON	2
CAL_HYP-DIATOM	CALANUS_HYPERBOREUS	DIATOM	4
CAL_HYP-FOR_IND	CALANUS_HYPERBOREUS	FORAMINIFERA	3
CAL_HYP-PHY_IND	CALANUS_HYPERBOREUS	PHYTOPLANKTON_INDET	4
CAL_HYP-PROZOO	CALANUS_HYPERBOREUS	PROTOZOOPLANKTON	2
CAR_SPP-CAR_SPP	CAREPROCTUS_SP	CAREPROCTUS_SP	4
CAR_SPP-MAL_VIL	CAREPROCTUS_SP	MALLOTUS_VILLOSUS	1
CAR_SPP-PAN_BOR	CAREPROCTUS_SP	PANDALUS_BOREALIS	1
CAR_SPP-SCL_SP	CAREPROCTUS_SP	SCLEROCRANGON_SP	1
CAR_SPP-THE_ABY	CAREPROCTUS_SP	THEMISTO_ABYSSORUM	2
CAR_SPP-THE_LIB	CAREPROCTUS_SP	THEMISTO_LIBELLULA	2
CAR_SPP-THY_INE	CAREPROCTUS_SP	THYSANOESSA_INERMIS	4
CHA_SP-CIR_IND	CHAETOZONE_SP	CIRRATULIDAE_INDET	3
CHA_SP-DET_IND	CHAETOZONE_SP	DETRITUS	4
CHA_SP-PHY_IND	CHAETOZONE_SP	PHYTOPLANKTON_INDET	3
CHI_OPI-AST_SP	CHIONOECETES_OPILIO	ASTARTE_SP	1
CHI_OPI-BRY_IND	CHIONOECETES_OPILIO	BRYOZOA_INDET	1
CHI_OPI-CAL_FIN	CHIONOECETES_OPILIO	CALANUS_FINMARCHICUS	1
CHI_OPI-CHI_OPI	CHIONOECETES_OPILIO	CHIONOECETES_OPILIO	1
CHI_OPI-CHO_SP	CHIONOECETES_OPILIO	CHONE_SP	1
CHI_OPI-DET_IND	CHIONOECETES_OPILIO	DETRITUS	1
CHI_OPI-DIATOM	CHIONOECETES_OPILIO	DIATOM	1
CHI_OPI-EUM_SPI	CHIONOECETES_OPILIO	EUMICROTREMUS_SPINOSUS	1
CHI_OPI-FOR_IND	CHIONOECETES_OPILIO	FORAMINIFERA	1
CHI_OPI-GAL_SP	CHIONOECETES_OPILIO	GALATHOWENIA_SP	1
CHI_OPI-HYA_SP	CHIONOECETES_OPILIO	HYAS_SP	1
CHI_OPI-MAC_SP	CHIONOECETES_OPILIO	MACOMA_SP	1
CHI_OPI-MAL_SAR	CHIONOECETES_OPILIO	MALDANE_SARSI	1
CHI_OPI-MAL_VIL	CHIONOECETES_OPILIO	MALLOTUS_VILLOSUS	1
CHI_OPI-MYR_HEE	CHIONOECETES_OPILIO	MYRIOCHELE_HERRI	1
CHI_OPI-OIT_SIM	CHIONOECETES_OPILIO	OITHONA_SPINIROSTRIS/ATLANTICA	1
CHI_OPI-OIT_SPI	CHIONOECETES_OPILIO	OITHONA_SIMILIS	4
CHI_OPI-OPH_ACU	CHIONOECETES_OPILIO	OPHIOPHOLIS_ACULEATA	4
CHI_OPI-OPH_BID	CHIONOECETES_OPILIO	OPHIACANTHA_BIDENTATA	4
CHI_OPI-OPH_BOR	CHIONOECETES_OPILIO	OPHIOPLEURA_BOREALIS	4
CHI_OPI-OPH_SER	CHIONOECETES_OPILIO	OPHIOCTEN_SERICEUM	4
CHI_OPI-OPH_SP	CHIONOECETES_OPILIO	OPHIURA_SP	1
CHI_OPI-PAG_SP	CHIONOECETES_OPILIO	PAGURUS_SP	1
CHI_OPI-PAN_BOR	CHIONOECETES_OPILIO	PANDALUS_BOREALIS	1
CHI_OPI-PHA_STR	CHIONOECETES_OPILIO	PHASCOLION_STROMBUS	1
CHI_OPI-POL_IND	CHIONOECETES_OPILIO	POLYCHAETA	1
CHI_OPI-POR_G_SP	CHIONOECETES_OPILIO	PORIFERA_G_SP	1
CHI_OPI-SIM_GRE	CHIONOECETES_OPILIO	SIMILIPECTEN_GREENLANDICUS	1
CHI_OPI-SPI_TYP	CHIONOECETES_OPILIO	SPIOCHAETOPTERUS_TYPICUS	1
CHI_OPI-STRO_SP	CHIONOECETES_OPILIO	STRONGYLOCENTROTUS_SP	1
CHI_OPI-YOL_SOL	CHIONOECETES_OPILIO	YOLDIELLA_SOLIDULA	4
CHL_ISL-AUT_FLA	CHLAMYS_ISLANDICA	AUTOTHROPH_FLAGELLAT	4
CHL_ISL-HET_FLA	CHLAMYS_ISLANDICA	HETEROTROPH_FLAGELLAT	4
CHO_SP-AUT_FLA	CHONE_SP	AUTOTHROPH_FLAGELLAT	4
CHO_SP-DET_IND	CHONE_SP	DETRITUS	4
CIO_INT-AUT_FLA	CIONA_INTESTINALIS	AUTOTHROPH_FLAGELLAT	1
CIO_INT-DIATOM	CIONA_INTESTINALIS	DIATOM	4
CIO_INT-HET_FLA	CIONA_INTESTINALIS	HETEROTROPH_FLAGELLAT	4
CIR_IND-DET_IND	CIRRATULIDAE_INDET	DETRITUS	1
CIR_IND-DIATOM	CIRRATULIDAE_INDET	DIATOM	1
CIR_IND-FOR_IND	CIRRATULIDAE_INDET	FORAMINIFERA	1
CIR_IND-PROZOO	CIRRATULIDAE_INDET	PROTOZOOPLANKTON	1
CLI_LIM-LIM_HEL	CLIONE_LIMACINA	LIMACINA_HELICINA	1
CLU_HAR-ACA_SPP	CLUPEA_HARENGUS	ACARTIA_SPP	1
CLU_HAR-AGL_DIG	CLUPEA_HARENGUS	AGLANTHA_DIGITALE	1
CLU_HAR-AMM_SPP	CLUPEA_HARENGUS	AMMODYTES_SPP	1
CLU_HAR-BEN_LAR	CLUPEA_HARENGUS	BENTHOS_LARVAE	1
CLU_HAR-BER_SP	CLUPEA_HARENGUS	BEROè_SP	1
CLU_HAR-CAL_FIN	CLUPEA_HARENGUS	CALANUS_FINMARCHICUS	1
CLU_HAR-CAL_GLA	CLUPEA_HARENGUS	CALANUS_GLACIALIS	2
CLU_HAR-CAL_HYP	CLUPEA_HARENGUS	CALANUS_HYPERBOREUS	1
CLU_HAR-CLI_LIM	CLUPEA_HARENGUS	CLIONE_LIMACINA	4
CLU_HAR-CLU_HAR	CLUPEA_HARENGUS	CLUPEA_HARENGUS	1
CLU_HAR-DIATOM	CLUPEA_HARENGUS	DIATOM	1
CLU_HAR-FRI_BOR	CLUPEA_HARENGUS	FRITILLARIA_BOREALIS	1
CLU_HAR-GAD_MOR	CLUPEA_HARENGUS	GADUS_MORHUA	1
CLU_HAR-HET_FLA	CLUPEA_HARENGUS	HETEROTROPH_FLAGELLAT	1
CLU_HAR-LIM_RET	CLUPEA_HARENGUS	LIMACINA_RETROVERSA	1
CLU_HAR-MAL_VIL	CLUPEA_HARENGUS	MALLOTUS_VILLOSUS	1
CLU_HAR-MEG_NOR	CLUPEA_HARENGUS	MEGANYCTIPHANES_NORVEGICA	1
CLU_HAR-MET_LON	CLUPEA_HARENGUS	METRIDIA_LONGA	1
CLU_HAR-MET_LUC	CLUPEA_HARENGUS	METRIDIA_LUCENS	1
CLU_HAR-MYO_SCO	CLUPEA_HARENGUS	MYOXOCEPHALUS_SCORPIUS	1
CLU_HAR-OIK_SPP	CLUPEA_HARENGUS	OIKOPLEURA_SPP	1
CLU_HAR-OIK_VAN	CLUPEA_HARENGUS	OIKOPLEURA_VANHOEFFENI	1
CLU_HAR-OIT_SIM	CLUPEA_HARENGUS	OITHONA_SPINIROSTRIS/ATLANTICA	1
CLU_HAR-ONC_BOR	CLUPEA_HARENGUS	ONCAEA_BOREALIS	1
CLU_HAR-PAR_NOR	CLUPEA_HARENGUS	PAREUCHAETA_NORVEGICA	1
CLU_HAR-PHY_IND	CLUPEA_HARENGUS	PHYTOPLANKTON_INDET	1
CLU_HAR-PROZOO	CLUPEA_HARENGUS	PROTOZOOPLANKTON	4
CLU_HAR-PSE_SPP	CLUPEA_HARENGUS	PSEUDOCALANUS_SPP	1
CLU_HAR-SAG_SPP	CLUPEA_HARENGUS	SAGITTA_SPP	1
CLU_HAR-THE_ABY	CLUPEA_HARENGUS	THEMISTO_ABYSSORUM	1
CLU_HAR-THE_LIB	CLUPEA_HARENGUS	THEMISTO_LIBELLULA	1
CLU_HAR-THY_INE	CLUPEA_HARENGUS	THYSANOESSA_INERMIS	1
CLU_HAR-THY_LON	CLUPEA_HARENGUS	THYSANOESSA_LONGICAUDATA	1
CLU_HAR-THY_RAS	CLUPEA_HARENGUS	THYSANOESSA_RASCHII	1
COL_SP-DET_IND	COLUS_SP	DETRITUS	1
COT_MIC-OPH_ACU	COTTUNCULUS_MICROPS	OPHIOPHOLIS_ACULEATA	3
COT_MIC-OPH_SP	COTTUNCULUS_MICROPS	OPHIURA_SP	3
COT_MIC-POL_IND	COTTUNCULUS_MICROPS	POLYCHAETA	1
COT_MIC-PYC_G_SP	COTTUNCULUS_MICROPS	PYCNOGONIDA_G_SP	1
CRO_PAP-AST_RUB	CROSSASTER_PAPPOSUS	ASTERIAS_RUBENS	2
CRO_PAP-BAL_SP	CROSSASTER_PAPPOSUS	BALANUS_SP	2
CRO_PAP-OPH_ACU	CROSSASTER_PAPPOSUS	OPHIOPHOLIS_ACULEATA	2
CRO_PAP-OPH_BID	CROSSASTER_PAPPOSUS	OPHIACANTHA_BIDENTATA	2
CRO_PAP-OPH_SP	CROSSASTER_PAPPOSUS	OPHIURA_SP	2
CRO_PAP-STRO_SP	CROSSASTER_PAPPOSUS	STRONGYLOCENTROTUS_SP	2
CTE_CRI-DET_IND	CTENODISCUS_CRISPATUS	DETRITUS	1
CUC_FRO-DET_IND	CUCUMARIA_FRONDOSA	DETRITUS	1
CUC_FRO-DIATOM	CUCUMARIA_FRONDOSA	DIATOM	1
CUC_FRO-PHY_IND	CUCUMARIA_FRONDOSA	PHYTOPLANKTON_INDET	1
CYA_CAP-ACA_SPP	CYANEA_CAPILLATA	ACARTIA_SPP	1
CYA_CAP-AGL_DIG	CYANEA_CAPILLATA	AGLANTHA_DIGITALE	1
CYA_CAP-AUR_AUR	CYANEA_CAPILLATA	AURELIA_AURITA	1
CYA_CAP-BAC_IND	CYANEA_CAPILLATA	BACTERIA_INDET	4
CYA_CAP-BER_SP	CYANEA_CAPILLATA	BEROè_SP	1
CYA_CAP-BOL_INF	CYANEA_CAPILLATA	BOLINOPSIS_INFUNDIBULUM	1
CYA_CAP-CAL_FIN	CYANEA_CAPILLATA	CALANUS_FINMARCHICUS	1
CYA_CAP-CAL_HYP	CYANEA_CAPILLATA	CALANUS_HYPERBOREUS	3
CYA_CAP-DIM_ARC	CYANEA_CAPILLATA	DIMOPHYES_ARCTICA	4
CYA_CAP-EUK_HAM	CYANEA_CAPILLATA	EUKROHNIA_HAMATA	4
CYA_CAP-FI_LA	CYANEA_CAPILLATA	FISH_LARVAE	1
CYA_CAP-FRI_BOR	CYANEA_CAPILLATA	FRITILLARIA_BOREALIS	4
CYA_CAP-MIC_SPP	CYANEA_CAPILLATA	MICROCALANUS_SPP	1
CYA_CAP-OIK_DIO	CYANEA_CAPILLATA	OIKOPLEURA_DIOICA	1
CYA_CAP-OIK_SPP	CYANEA_CAPILLATA	OIKOPLEURA_SPP	1
CYA_CAP-OIT_SIM	CYANEA_CAPILLATA	OITHONA_SPINIROSTRIS/ATLANTICA	1
CYA_CAP-OIT_SPI	CYANEA_CAPILLATA	OITHONA_SIMILIS	4
CYA_CAP-ONC_BOR	CYANEA_CAPILLATA	ONCAEA_BOREALIS	1
CYA_CAP-PSE_SPP	CYANEA_CAPILLATA	PSEUDOCALANUS_SPP	1
CYA_CAP-SAG_SPP	CYANEA_CAPILLATA	SAGITTA_SPP	4
CYA_CAP-SAR_SPP	CYANEA_CAPILLATA	SARSIA_SPP	1
CYA_CAP-THE_LIB	CYANEA_CAPILLATA	THEMISTO_LIBELLULA	4
CYC_LUM-APH_GLA	CYCLOPTERUS_LUMPUS	APHERUSA_GLACIALIS	2
CYC_LUM-ASC_G_SP	CYCLOPTERUS_LUMPUS	ASCIDIACEA_G_SP	4
CYC_LUM-GAM_WIL	CYCLOPTERUS_LUMPUS	GAMMARUS_WILKITZKII	2
CYC_LUM-ONI_GLA	CYCLOPTERUS_LUMPUS	ONISIMUS_GLACIALIS	2
CYC_LUM-ONI_NAN	CYCLOPTERUS_LUMPUS	ONISIMUS_NANSENI	2
CYC_LUM-OPH_ACU	CYCLOPTERUS_LUMPUS	OPHIOPHOLIS_ACULEATA	2
CYC_LUM-OPH_SP	CYCLOPTERUS_LUMPUS	OPHIURA_SP	2
CYC_LUM-THE_LIB	CYCLOPTERUS_LUMPUS	THEMISTO_LIBELLULA	3
CYS_CRI-AMM_SPP	CYSTOPHORA_CRISTATA	AMMODYTES_SPP	1
CYS_CRI-ANA_DEN	CYSTOPHORA_CRISTATA	ANARHICHAS_DENTICULATUS	2
CYS_CRI-ANA_LUP	CYSTOPHORA_CRISTATA	ANARHICHAS_LUPUS	2
CYS_CRI-ANA_MIN	CYSTOPHORA_CRISTATA	ANARHICHAS_MINOR	2
CYS_CRI-BOR_SAI	CYSTOPHORA_CRISTATA	BOREOGADUS_SAIDA	1
CYS_CRI-CLU_HAR	CYSTOPHORA_CRISTATA	CLUPEA_HARENGUS	1
CYS_CRI-GAD_MOR	CYSTOPHORA_CRISTATA	GADUS_MORHUA	1
CYS_CRI-GAM_WIL	CYSTOPHORA_CRISTATA	GAMMARUS_WILKITZKII	4
CYS_CRI-GON_FAB	CYSTOPHORA_CRISTATA	GONATUS_FABRICII	1
CYS_CRI-HIP_PLA	CYSTOPHORA_CRISTATA	HIPPOGLOSSOIDES_PLATESSOIDES	1
CYS_CRI-LIP_FAB	CYSTOPHORA_CRISTATA	LIPARIS_FABRICII	4
CYS_CRI-LIP_GIB	CYSTOPHORA_CRISTATA	LIPARIS_GIBBUS	1
CYS_CRI-LIP_MON	CYSTOPHORA_CRISTATA	LIPARIS_MONTAGUI	1
CYS_CRI-MAL_VIL	CYSTOPHORA_CRISTATA	MALLOTUS_VILLOSUS	1
CYS_CRI-MEL_AEG	CYSTOPHORA_CRISTATA	MELANOGRAMMUS_AEGLEFINUS	1
CYS_CRI-PAN_BOR	CYSTOPHORA_CRISTATA	PANDALUS_BOREALIS	1
CYS_CRI-POL_VIR	CYSTOPHORA_CRISTATA	POLLACHIUS_VIRENS	4
CYS_CRI-SEB_MAR	CYSTOPHORA_CRISTATA	SEBASTES_MARINUS	1
CYS_CRI-SEB_MEN	CYSTOPHORA_CRISTATA	SEBASTES_MENTELLA	2
CYS_CRI-THE_ABY	CYSTOPHORA_CRISTATA	THEMISTO_ABYSSORUM	1
CYS_CRI-THE_LIB	CYSTOPHORA_CRISTATA	THEMISTO_LIBELLULA	1
CYS_CRI-THY_INE	CYSTOPHORA_CRISTATA	THYSANOESSA_INERMIS	3
CYS_CRI-THY_LON	CYSTOPHORA_CRISTATA	THYSANOESSA_LONGICAUDATA	3
CYS_CRI-THY_RAS	CYSTOPHORA_CRISTATA	THYSANOESSA_RASCHII	3
DEL_LEU-AMM_SPP	DELPHINAPTERUS_LEUCAS	AMMODYTES_SPP	2
DEL_LEU-ANI_MED	DELPHINAPTERUS_LEUCAS	ANISARCHUS_MEDIUS	4
DEL_LEU-ARC_GLA	DELPHINAPTERUS_LEUCAS	ARCTOGADUS_GLACIALIS	1
DEL_LEU-BOR_SAI	DELPHINAPTERUS_LEUCAS	BOREOGADUS_SAIDA	1
DEL_LEU-CLU_HAR	DELPHINAPTERUS_LEUCAS	CLUPEA_HARENGUS	1
DEL_LEU-GAD_MOR	DELPHINAPTERUS_LEUCAS	GADUS_MORHUA	2
DEL_LEU-GON_FAB	DELPHINAPTERUS_LEUCAS	GONATUS_FABRICII	1
DEL_LEU-HYA_SP	DELPHINAPTERUS_LEUCAS	HYAS_SP	1
DEL_LEU-LUM_LAM	DELPHINAPTERUS_LEUCAS	LUMPENUS_LAMPRETAEFORMIS	4
DEL_LEU-MAL_VIL	DELPHINAPTERUS_LEUCAS	MALLOTUS_VILLOSUS	1
DEL_LEU-PAN_BOR	DELPHINAPTERUS_LEUCAS	PANDALUS_BOREALIS	1
DEL_LEU-REI_HIP	DELPHINAPTERUS_LEUCAS	REINHARDTIUS_HIPPOGLOSSOIDES	1
DEL_LEU-SAB_SP	DELPHINAPTERUS_LEUCAS	SABINEA_SP	1
DEL_LEU-SCL_SP	DELPHINAPTERUS_LEUCAS	SCLEROCRANGON_SP	1
DEL_LEU-SEB_MAR	DELPHINAPTERUS_LEUCAS	SEBASTES_MARINUS	2
DEL_LEU-SEB_MEN	DELPHINAPTERUS_LEUCAS	SEBASTES_MENTELLA	1
DEL_LEU-SEB_SPP	DELPHINAPTERUS_LEUCAS	SEBASTES_SPP	1
DIM_ARC-PHY_IND	DIMOPHYES_ARCTICA	PHYTOPLANKTON_INDET	4
ELE_ARC-DET_IND	ELECTRA_ARCTICA	DETRITUS	1
ELE_ARC-DIATOM	ELECTRA_ARCTICA	DIATOM	1
ELE_ARC-PHY_IND	ELECTRA_ARCTICA	PHYTOPLANKTON_INDET	1
ENC_CIM-PAN_BOR	ENCHELYOPUS_CIMBRIUS	PANDALUS_BOREALIS	4
ENC_CIM-POL_IND	ENCHELYOPUS_CIMBRIUS	POLYCHAETA	1
ERI_BAR-ACT_G_SP	ERIGNATHUS_BARBATUS	ACTINIARIA_G_SP	1
ERI_BAR-ARC_GLA	ERIGNATHUS_BARBATUS	ARCTOGADUS_GLACIALIS	1
ERI_BAR-AST_SP	ERIGNATHUS_BARBATUS	ASTARTE_SP	1
ERI_BAR-BOR_SAI	ERIGNATHUS_BARBATUS	BOREOGADUS_SAIDA	1
ERI_BAR-BUC_SP	ERIGNATHUS_BARBATUS	BUCCINUM_SP	1
ERI_BAR-CUC_FRO	ERIGNATHUS_BARBATUS	CUCUMARIA_FRONDOSA	4
ERI_BAR-EUM_SPI	ERIGNATHUS_BARBATUS	EUMICROTREMUS_SPINOSUS	1
ERI_BAR-FI_LA	ERIGNATHUS_BARBATUS	FISH_LARVAE	1
ERI_BAR-GAD_ARG	ERIGNATHUS_BARBATUS	GADICULUS_ARGENTEUS	4
ERI_BAR-GAD_MOR	ERIGNATHUS_BARBATUS	GADUS_MORHUA	1
ERI_BAR-GAM_WIL	ERIGNATHUS_BARBATUS	GAMMARUS_WILKITZKII	4
ERI_BAR-GON_FAB	ERIGNATHUS_BARBATUS	GONATUS_FABRICII	4
ERI_BAR-HIP_HIP	ERIGNATHUS_BARBATUS	HIPPOGLOSSUS_HIPPOGLOSSUS	2
ERI_BAR-HIP_PLA	ERIGNATHUS_BARBATUS	HIPPOGLOSSOIDES_PLATESSOIDES	1
ERI_BAR-HYA_SP	ERIGNATHUS_BARBATUS	HYAS_SP	1
ERI_BAR-LUM_FAB	ERIGNATHUS_BARBATUS	LUMPENUS_FABRICII	4
ERI_BAR-LUM_LAM	ERIGNATHUS_BARBATUS	LUMPENUS_LAMPRETAEFORMIS	4
ERI_BAR-LYC_GRA	ERIGNATHUS_BARBATUS	LYCODES_GRACILIS	4
ERI_BAR-LYC_KOL	ERIGNATHUS_BARBATUS	LYCENCHELYS_KOLTHOFFI	4
ERI_BAR-LYC_RET	ERIGNATHUS_BARBATUS	LYCODES_RETICULATUS	4
ERI_BAR-LYC_SEM	ERIGNATHUS_BARBATUS	LYCODES_SEMINUDUS	4
ERI_BAR-MAC_SP	ERIGNATHUS_BARBATUS	MACOMA_SP	1
ERI_BAR-MOL_BOR	ERIGNATHUS_BARBATUS	MOLPADIA_BOREALIS	4
ERI_BAR-MYO_SCO	ERIGNATHUS_BARBATUS	MYOXOCEPHALUS_SCORPIUS	1
ERI_BAR-OPH_SP	ERIGNATHUS_BARBATUS	OPHIURA_SP	1
ERI_BAR-PAG_SP	ERIGNATHUS_BARBATUS	PAGURUS_SP	2
ERI_BAR-PAN_BOR	ERIGNATHUS_BARBATUS	PANDALUS_BOREALIS	1
ERI_BAR-POL_IND	ERIGNATHUS_BARBATUS	POLYCHAETA	1
ERI_BAR-POLY_IND	ERIGNATHUS_BARBATUS	POLYNOIDAE_INDET	1
ERI_BAR-ROS_SP	ERIGNATHUS_BARBATUS	ROSSIA_SP	1
ERI_BAR-SAB_SP	ERIGNATHUS_BARBATUS	SABINEA_SP	1
ERI_BAR-SCA_INF	ERIGNATHUS_BARBATUS	SCALIBREGMA_INFLATUM	1
ERI_BAR-SCL_SP	ERIGNATHUS_BARBATUS	SCLEROCRANGON_SP	1
ERI_BAR-STI_TRE	ERIGNATHUS_BARBATUS	STICHOPUS_TREMULUS	4
ERY_SP-AUT_FLA	ERYTHROPS_SP	AUTOTHROPH_FLAGELLAT	1
ERY_SP-BAC_IND	ERYTHROPS_SP	BACTERIA_INDET	4
ERY_SP-DET_IND	ERYTHROPS_SP	DETRITUS	1
ERY_SP-DIATOM	ERYTHROPS_SP	DIATOM	1
ERY_SP-FOR_IND	ERYTHROPS_SP	FORAMINIFERA	4
ERY_SP-HET_FLA	ERYTHROPS_SP	HETEROTROPH_FLAGELLAT	1
ERY_SP-PHY_IND	ERYTHROPS_SP	PHYTOPLANKTON_INDET	1
ERY_SP-THE_ABY	ERYTHROPS_SP	THEMISTO_ABYSSORUM	4
ERY_SP-THE_LIB	ERYTHROPS_SP	THEMISTO_LIBELLULA	4
ERY_SP-THY_INE	ERYTHROPS_SP	THYSANOESSA_INERMIS	4
ETM_SPI-GAD_ARG	ETMOPTERUS_SPINAX	GADICULUS_ARGENTEUS	1
ETM_SPI-GAM_WIL	ETMOPTERUS_SPINAX	GAMMARUS_WILKITZKII	4
ETM_SPI-MAU_MUE	ETMOPTERUS_SPINAX	MAUROLICUS_MUELLERI	1
ETM_SPI-MEG_NOR	ETMOPTERUS_SPINAX	MEGANYCTIPHANES_NORVEGICA	1
ETM_SPI-MIC_POU	ETMOPTERUS_SPINAX	MICROMESISTIUS_POUTASSOU	1
ETM_SPI-NEM_MEG	ETMOPTERUS_SPINAX	NEMATOSCELIS_MEGALOPS	1
EUC_IND-DET_IND	EUCLYMENINAE_INDET	DETRITUS	4
EUK_HAM-MET_LON	EUKROHNIA_HAMATA	METRIDIA_LONGA	4
EUK_HAM-MET_LUC	EUKROHNIA_HAMATA	METRIDIA_LUCENS	4
EUK_HAM-MIC_SPP	EUKROHNIA_HAMATA	MICROCALANUS_SPP	4
EUK_HAM-OIT_SIM	EUKROHNIA_HAMATA	OITHONA_SPINIROSTRIS/ATLANTICA	4
EUK_HAM-OIT_SPI	EUKROHNIA_HAMATA	OITHONA_SIMILIS	4
EUK_HAM-PAR_SPP	EUKROHNIA_HAMATA	PAREUCHAETA_SPP	4
EUK_HAM-POL_IND	EUKROHNIA_HAMATA	POLYCHAETA	4
EUK_HAM-SAG_SPP	EUKROHNIA_HAMATA	SAGITTA_SPP	4
EUM_SPI-GAM_WIL	EUMICROTREMUS_SPINOSUS	GAMMARUS_WILKITZKII	1
EUM_SPI-MEG_NOR	EUMICROTREMUS_SPINOSUS	MEGANYCTIPHANES_NORVEGICA	4
EUM_SPI-PAN_BOR	EUMICROTREMUS_SPINOSUS	PANDALUS_BOREALIS	1
EUM_SPI-POL_IND	EUMICROTREMUS_SPINOSUS	POLYCHAETA	1
EUM_SPI-THE_ABY	EUMICROTREMUS_SPINOSUS	THEMISTO_ABYSSORUM	1
EUM_SPI-THE_LIB	EUMICROTREMUS_SPINOSUS	THEMISTO_LIBELLULA	1
EUM_SPI-THY_INE	EUMICROTREMUS_SPINOSUS	THYSANOESSA_INERMIS	1
EUP_FLAM-CAL_FIN	EUPHYSA_FLAMMEA	CALANUS_FINMARCHICUS	2
EUP_FLAM-CAL_GLA	EUPHYSA_FLAMMEA	CALANUS_GLACIALIS	2
EUP_FLAM-CAL_HYP	EUPHYSA_FLAMMEA	CALANUS_HYPERBOREUS	2
EUP_FLAM-MET_LON	EUPHYSA_FLAMMEA	METRIDIA_LONGA	2
EUP_FLAM-MIC_SPP	EUPHYSA_FLAMMEA	MICROCALANUS_SPP	2
EUP_FLAM-OIT_SIM	EUPHYSA_FLAMMEA	OITHONA_SPINIROSTRIS/ATLANTICA	2
EUP_FLAM-PSE_SPP	EUPHYSA_FLAMMEA	PSEUDOCALANUS_SPP	2
FI_LA-AUT_FLA	FISH_LARVAE	AUTOTHROPH_FLAGELLAT	4
FI_LA-BEN_LAR	FISH_LARVAE	BENTHOS_LARVAE	4
FI_LA-DIATOM	FISH_LARVAE	DIATOM	4
FI_LA-HET_FLA	FISH_LARVAE	HETEROTROPH_FLAGELLAT	4
FI_LA-MIX_FLA	FISH_LARVAE	MIXOTROPH_FLAGELLATES	4
FI_LA-PHY_IND	FISH_LARVAE	PHYTOPLANKTON_INDET	4
FOR_IND-BAC_IND	FORAMINIFERA	BACTERIA_INDET	1
FOR_IND-DIATOM	FORAMINIFERA	DIATOM	1
FRA_ARC_THE_LIB	FRATERCULA_ARCTICA	THEMISTO_LIBELLULA	4
FRA_ARC-AMM_SPP	FRATERCULA_ARCTICA	AMMODYTES_SPP	1
FRA_ARC-BEN_GLA	FRATERCULA_ARCTICA	BENTHOSEMA_GLACIALE	1
FRA_ARC-CLU_HAR	FRATERCULA_ARCTICA	CLUPEA_HARENGUS	1
FRA_ARC-GON_FAB	FRATERCULA_ARCTICA	GONATUS_FABRICII	4
FRA_ARC-MAL_VIL	FRATERCULA_ARCTICA	MALLOTUS_VILLOSUS	1
FRA_ARC-MEL_AEG	FRATERCULA_ARCTICA	MELANOGRAMMUS_AEGLEFINUS	4
FRA_ARC-MIC_POU	FRATERCULA_ARCTICA	MICROMESISTIUS_POUTASSOU	1
FRA_ARC-POL_IND	FRATERCULA_ARCTICA	POLYCHAETA	1
FRA_ARC-POL_VIR	FRATERCULA_ARCTICA	POLLACHIUS_VIRENS	4
FRA_ARC-THE_ABY	FRATERCULA_ARCTICA	THEMISTO_ABYSSORUM	1
FRA_ARC-THY_INE	FRATERCULA_ARCTICA	THYSANOESSA_INERMIS	1
FRA_ARC-TRI_ESM	FRATERCULA_ARCTICA	TRISOPTERUS_ESMARKII	1
FRI_BOR-PHY_IND	FRITILLARIA_BOREALIS	PHYTOPLANKTON_INDET	1
FRI_BOR-SAG_SPP	FRITILLARIA_BOREALIS	SAGITTA_SPP	4
FUL_GLA-AMM_SPP	FULMARUS_GLACIALIS	AMMODYTES_SPP	1
FUL_GLA-APH_GLA	FULMARUS_GLACIALIS	APHERUSA_GLACIALIS	1
FUL_GLA-ARG_SP	FULMARUS_GLACIALIS	ARGENTINA_SP	1
FUL_GLA-BOR_SAI	FULMARUS_GLACIALIS	BOREOGADUS_SAIDA	1
FUL_GLA-CAL_FIN	FULMARUS_GLACIALIS	CALANUS_FINMARCHICUS	1
FUL_GLA-CAL_HYP	FULMARUS_GLACIALIS	CALANUS_HYPERBOREUS	1
FUL_GLA-CLU_HAR	FULMARUS_GLACIALIS	CLUPEA_HARENGUS	1
FUL_GLA-FI_LA	FULMARUS_GLACIALIS	FISH_LARVAE	1
FUL_GLA-GAD_MOR	FULMARUS_GLACIALIS	GADUS_MORHUA	1
FUL_GLA-GAM_WIL	FULMARUS_GLACIALIS	GAMMARUS_WILKITZKII	1
FUL_GLA-GON_FAB	FULMARUS_GLACIALIS	GONATUS_FABRICII	1
FUL_GLA-HIP_PLA	FULMARUS_GLACIALIS	HIPPOGLOSSOIDES_PLATESSOIDES	1
FUL_GLA-LIM_LIM	FULMARUS_GLACIALIS	LIMANDA_LIMANDA	1
FUL_GLA-MAL_VIL	FULMARUS_GLACIALIS	MALLOTUS_VILLOSUS	1
FUL_GLA-MEG_NOR	FULMARUS_GLACIALIS	MEGANYCTIPHANES_NORVEGICA	1
FUL_GLA-MEL_AEG	FULMARUS_GLACIALIS	MELANOGRAMMUS_AEGLEFINUS	1
FUL_GLA-MER_MER	FULMARUS_GLACIALIS	MERLANGIUS_MERLANGUS	1
FUL_GLA-ONI_GLA	FULMARUS_GLACIALIS	ONISIMUS_GLACIALIS	1
FUL_GLA-ONI_NAN	FULMARUS_GLACIALIS	ONISIMUS_NANSENI	1
FUL_GLA-OST_IND	FULMARUS_GLACIALIS	OSTRACODA_INDET	1
FUL_GLA-PAG_SP	FULMARUS_GLACIALIS	PAGURUS_SP	1
FUL_GLA-PAN_BOR	FULMARUS_GLACIALIS	PANDALUS_BOREALIS	1
FUL_GLA-ROS_SP	FULMARUS_GLACIALIS	ROSSIA_SP	4
FUL_GLA-SCO_SCO	FULMARUS_GLACIALIS	SCOMBER_SCOMBRUS	1
FUL_GLA-SEB_MAR	FULMARUS_GLACIALIS	SEBASTES_MARINUS	1
FUL_GLA-SEB_MEN	FULMARUS_GLACIALIS	SEBASTES_MENTELLA	1
FUL_GLA-SEB_SPP	FULMARUS_GLACIALIS	SEBASTES_SPP	1
FUL_GLA-THE_ABY	FULMARUS_GLACIALIS	THEMISTO_ABYSSORUM	1
FUL_GLA-THE_LIB	FULMARUS_GLACIALIS	THEMISTO_LIBELLULA	1
FUL_GLA-THY_INE	FULMARUS_GLACIALIS	THYSANOESSA_INERMIS	1
FUL_GLA-TRI_ESM	FULMARUS_GLACIALIS	TRISOPTERUS_ESMARKII	1
GAD_ARG-CAL_FIN	GADICULUS_ARGENTEUS	CALANUS_FINMARCHICUS	1
GAD_ARG-CAL_HYP	GADICULUS_ARGENTEUS	CALANUS_HYPERBOREUS	4
GAD_ARG-EUK_HAM	GADICULUS_ARGENTEUS	EUKROHNIA_HAMATA	1
GAD_ARG-HIP_PLA	GADICULUS_ARGENTEUS	HIPPOGLOSSOIDES_PLATESSOIDES	1
GAD_ARG-MEG_NOR	GADICULUS_ARGENTEUS	MEGANYCTIPHANES_NORVEGICA	3
GAD_ARG-MET_LON	GADICULUS_ARGENTEUS	METRIDIA_LONGA	1
GAD_ARG-MET_LUC	GADICULUS_ARGENTEUS	METRIDIA_LUCENS	1
GAD_ARG-PAR_NOR	GADICULUS_ARGENTEUS	PAREUCHAETA_NORVEGICA	1
GAD_ARG-SAG_SPP	GADICULUS_ARGENTEUS	SAGITTA_SPP	4
GAD_ARG-THY_INE	GADICULUS_ARGENTEUS	THYSANOESSA_INERMIS	4
GAD_MOR-ACA_SPP	GADUS_MORHUA	ACARTIA_SPP	1
GAD_MOR-ACT_G_SP	GADUS_MORHUA	ACTINIARIA_G_SP	1
GAD_MOR-AGL_DIG	GADUS_MORHUA	AGLANTHA_DIGITALE	1
GAD_MOR-AGO_CAT	GADUS_MORHUA	AGONUS_CATAPHRACTUS	4
GAD_MOR-AMB_HYP	GADUS_MORHUA	AMBLYRAJA_HYPERBOREA	4
GAD_MOR-AMB_RAD	GADUS_MORHUA	AMBLYRAJA_RADIATA	3
GAD_MOR-AMM_SPP	GADUS_MORHUA	AMMODYTES_SPP	1
GAD_MOR-ANA_DEN	GADUS_MORHUA	ANARHICHAS_DENTICULATUS	4
GAD_MOR-ANA_LUP	GADUS_MORHUA	ANARHICHAS_LUPUS	1
GAD_MOR-ANA_MIN	GADUS_MORHUA	ANARHICHAS_MINOR	1
GAD_MOR-ANI_MED	GADUS_MORHUA	ANISARCHUS_MEDIUS	3
GAD_MOR-APH_MAR	GADUS_MORHUA	APHELOCHAETA_MARIONI	4
GAD_MOR-ARC_RIS	GADUS_MORHUA	ARCTOZENUS_RISSO	4
GAD_MOR-ART_ATL	GADUS_MORHUA	ARTEDIELLUS_ATLANTICUS	1
GAD_MOR-AST_SP	GADUS_MORHUA	ASTARTE_SP	1
GAD_MOR-AUR_AUR	GADUS_MORHUA	AURELIA_AURITA	1
GAD_MOR-BAL_SP	GADUS_MORHUA	BALANUS_SP	1
GAD_MOR-BAT_SPI	GADUS_MORHUA	BATHYRAJA_SPINICAUDA	4
GAD_MOR-BEN_GLA	GADUS_MORHUA	BENTHOSEMA_GLACIALE	1
GAD_MOR-BER_SP	GADUS_MORHUA	BEROè_SP	1
GAD_MOR-BOL_INF	GADUS_MORHUA	BOLINOPSIS_INFUNDIBULUM	1
GAD_MOR-BOR_SAI	GADUS_MORHUA	BOREOGADUS_SAIDA	1
GAD_MOR-BRO_BRO	GADUS_MORHUA	BROSME_BROSME	1
GAD_MOR-BUC_SP	GADUS_MORHUA	BUCCINUM_SP	1
GAD_MOR-CAL_FIN	GADUS_MORHUA	CALANUS_FINMARCHICUS	1
GAD_MOR-CAL_GLA	GADUS_MORHUA	CALANUS_GLACIALIS	2
GAD_MOR-CAL_HYP	GADUS_MORHUA	CALANUS_HYPERBOREUS	1
GAD_MOR-CAR_SPP	GADUS_MORHUA	CAREPROCTUS_SP	3
GAD_MOR-CHI_OPI	GADUS_MORHUA	CHIONOECETES_OPILIO	1
GAD_MOR-CLU_HAR	GADUS_MORHUA	CLUPEA_HARENGUS	1
GAD_MOR-CTE_CRI	GADUS_MORHUA	CTENODISCUS_CRISPATUS	1
GAD_MOR-CUC_FRO	GADUS_MORHUA	CUCUMARIA_FRONDOSA	1
GAD_MOR-ENC_CIM	GADUS_MORHUA	ENCHELYOPUS_CIMBRIUS	4
GAD_MOR-ERY_SP	GADUS_MORHUA	ERYTHROPS_SP	1
GAD_MOR-FI_LA	GADUS_MORHUA	FISH_LARVAE	1
GAD_MOR-GAD_MOR	GADUS_MORHUA	GADUS_MORHUA	1
GAD_MOR-GAM_IND	GADUS_MORHUA	GAMMARIDAE_INDET	1
GAD_MOR-GAS_ACU	GADUS_MORHUA	GASTEROSTEUS_ACULEATUS	1
GAD_MOR-GON_FAB	GADUS_MORHUA	GONATUS_FABRICII	1
GAD_MOR-GYM_SPP	GADUS_MORHUA	GYMNELUS_SPP	4
GAD_MOR-GYM_TRI	GADUS_MORHUA	GYMNOCANTHUS_TRICUSPIS	1
GAD_MOR-HIP_HIP	GADUS_MORHUA	HIPPOGLOSSUS_HIPPOGLOSSUS	3
GAD_MOR-HIP_PLA	GADUS_MORHUA	HIPPOGLOSSOIDES_PLATESSOIDES	1
GAD_MOR-HYA_SP	GADUS_MORHUA	HYAS_SP	1
GAD_MOR-ICE_SPP	GADUS_MORHUA	ICELUS_SPP	1
GAD_MOR-LEP_DEC	GADUS_MORHUA	LEPTAGONUS_DECAGONUS	3
GAD_MOR-LIM_LIM	GADUS_MORHUA	LIMANDA_LIMANDA	1
GAD_MOR-LIP_FAB	GADUS_MORHUA	LIPARIS_FABRICII	3
GAD_MOR-LIP_GIB	GADUS_MORHUA	LIPARIS_GIBBUS	3
GAD_MOR-LIP_MON	GADUS_MORHUA	LIPARIS_MONTAGUI	3
GAD_MOR-LUM_LAM	GADUS_MORHUA	LUMPENUS_LAMPRETAEFORMIS	1
GAD_MOR-LUM_SP	GADUS_MORHUA	LUMBRINERIS_SP	1
GAD_MOR-LYC_ESM	GADUS_MORHUA	LYCENCHELYS_KOLTHOFFI	1
GAD_MOR-LYC_EUD	GADUS_MORHUA	LYCODES_EUDIPLEUROSTICTUS	4
GAD_MOR-LYC_GRA	GADUS_MORHUA	LYCODES_GRACILIS	4
GAD_MOR-LYC_PAL	GADUS_MORHUA	LYCODES_PALLIDUS	1
GAD_MOR-LYC_ROS	GADUS_MORHUA	LYCODES_ROSSI	1
GAD_MOR-MAL_SAR	GADUS_MORHUA	MALDANE_SARSI	1
GAD_MOR-MAL_VIL	GADUS_MORHUA	MALLOTUS_VILLOSUS	1
GAD_MOR-MAU_MUE	GADUS_MORHUA	MAUROLICUS_MUELLERI	1
GAD_MOR-MEG_NOR	GADUS_MORHUA	MEGANYCTIPHANES_NORVEGICA	1
GAD_MOR-MEL_AEG	GADUS_MORHUA	MELANOGRAMMUS_AEGLEFINUS	1
GAD_MOR-MER_MER	GADUS_MORHUA	MERLANGIUS_MERLANGUS	4
GAD_MOR-MET_LON	GADUS_MORHUA	METRIDIA_LONGA	1
GAD_MOR-MIC_POU	GADUS_MORHUA	MICROMESISTIUS_POUTASSOU	1
GAD_MOR-MYO_SCO	GADUS_MORHUA	MYOXOCEPHALUS_SCORPIUS	1
GAD_MOR-OIK_SPP	GADUS_MORHUA	OIKOPLEURA_SPP	1
GAD_MOR-OIT_SIM	GADUS_MORHUA	OITHONA_SPINIROSTRIS/ATLANTICA	1
GAD_MOR-OPH_ACU	GADUS_MORHUA	OPHIOPHOLIS_ACULEATA	1
GAD_MOR-OPH_BID	GADUS_MORHUA	OPHIACANTHA_BIDENTATA	1
GAD_MOR-OPH_SER	GADUS_MORHUA	OPHIOCTEN_SERICEUM	1
GAD_MOR-OPH_SP	GADUS_MORHUA	OPHIURA_SP	1
GAD_MOR-OST_IND	GADUS_MORHUA	OSTRACODA_INDET	1
GAD_MOR-PAG_SP	GADUS_MORHUA	PAGURUS_SP	1
GAD_MOR-PAN_BOR	GADUS_MORHUA	PANDALUS_BOREALIS	1
GAD_MOR-PLE_PLA	GADUS_MORHUA	PLEURONECTES_PLATESSA	1
GAD_MOR-POL_IND	GADUS_MORHUA	POLYCHAETA	1
GAD_MOR-POL_VIR	GADUS_MORHUA	POLLACHIUS_VIRENS	1
GAD_MOR-POR_G_SP	GADUS_MORHUA	PORIFERA_G_SP	1
GAD_MOR-PSE_SPP	GADUS_MORHUA	PSEUDOCALANUS_SPP	1
GAD_MOR-PYC_G_SP	GADUS_MORHUA	PYCNOGONIDA_G_SP	1
GAD_MOR-RAJ_FYL	GADUS_MORHUA	RAJELLA_FYLLAE	4
GAD_MOR-REI_HIP	GADUS_MORHUA	REINHARDTIUS_HIPPOGLOSSOIDES	1
GAD_MOR-RHA_SP	GADUS_MORHUA	RHACHOTROPIS_SP	4
GAD_MOR-ROS_SP	GADUS_MORHUA	ROSSIA_SP	1
GAD_MOR-SAB_SP	GADUS_MORHUA	SABINEA_SP	1
GAD_MOR-SAG_SPP	GADUS_MORHUA	SAGITTA_SPP	1
GAD_MOR-SCL_SP	GADUS_MORHUA	SCLEROCRANGON_SP	1
GAD_MOR-SEB_MAR	GADUS_MORHUA	SEBASTES_MARINUS	1
GAD_MOR-SEB_MEN	GADUS_MORHUA	SEBASTES_MENTELLA	1
GAD_MOR-SEB_VIV	GADUS_MORHUA	SEBASTES_VIVIPARUS	1
GAD_MOR-SPI_TYP	GADUS_MORHUA	SPIOCHAETOPTERUS_TYPICUS	1
GAD_MOR-STRO_SP	GADUS_MORHUA	STRONGYLOCENTROTUS_SP	1
GAD_MOR-TER_STRO	GADUS_MORHUA	TEREBELLIDES_STROEMI	1
GAD_MOR-THE_ABY	GADUS_MORHUA	THEMISTO_ABYSSORUM	1
GAD_MOR-THE_LIB	GADUS_MORHUA	THEMISTO_LIBELLULA	1
GAD_MOR-THY_GOU	GADUS_MORHUA	THYASIRA_GOULDI	1
GAD_MOR-THY_INE	GADUS_MORHUA	THYSANOESSA_INERMIS	1
GAD_MOR-THY_LON	GADUS_MORHUA	THYSANOESSA_LONGICAUDATA	4
GAD_MOR-THY_RAS	GADUS_MORHUA	THYSANOESSA_RASCHII	4
GAD_MOR-TRI_ESM	GADUS_MORHUA	TRISOPTERUS_ESMARKII	1
GAD_MOR-TRI_MUR	GADUS_MORHUA	TRIGLOPS_MURRAYI	1
GAD_MOR-TRI_PIN	GADUS_MORHUA	TRIGLOPS_PINGELII	1
GAI_ARG-MAL_VIL	GAIDROPSARUS_ARGENTATUS	MALLOTUS_VILLOSUS	1
GAI_ARG-MEG_NOR	GAIDROPSARUS_ARGENTATUS	MEGANYCTIPHANES_NORVEGICA	1
GAI_ARG-NYC_COU	GAIDROPSARUS_ARGENTATUS	NYCTIPHANES_COUCHII	4
GAI_ARG-POL_IND	GAIDROPSARUS_ARGENTATUS	POLYCHAETA	1
GAI_ARG-THE_ABY	GAIDROPSARUS_ARGENTATUS	THEMISTO_ABYSSORUM	1
GAI_ARG-THE_LIB	GAIDROPSARUS_ARGENTATUS	THEMISTO_LIBELLULA	1
GAI_ARG-THY_INE	GAIDROPSARUS_ARGENTATUS	THYSANOESSA_INERMIS	1
GAI_ARG-THY_LON	GAIDROPSARUS_ARGENTATUS	THYSANOESSA_LONGICAUDATA	1
GAI_ARG-THY_RAS	GAIDROPSARUS_ARGENTATUS	THYSANOESSA_RASCHII	1
GAL_SP-DET_IND	GALATHOWENIA_SP	DETRITUS	4
GAL_SP-PHY_IND	GALATHOWENIA_SP	PHYTOPLANKTON_INDET	4
GAM_IND-DET_IND	GAMMARIDAE_INDET	DETRITUS	4
GAM_IND-DIATOM	GAMMARIDAE_INDET	DIATOM	4
GAM_IND-PHY_IND	GAMMARIDAE_INDET	PHYTOPLANKTON_INDET	4
GAM_WIL-BAC_IND	GAMMARUS_WILKITZKII	BACTERIA_INDET	1
GAM_WIL-CAL_FIN	GAMMARUS_WILKITZKII	CALANUS_FINMARCHICUS	2
GAM_WIL-CAL_GLA	GAMMARUS_WILKITZKII	CALANUS_GLACIALIS	2
GAM_WIL-CAL_HYP	GAMMARUS_WILKITZKII	CALANUS_HYPERBOREUS	1
GAM_WIL-DET_IND	GAMMARUS_WILKITZKII	DETRITUS	1
GAM_WIL-GAM_WIL	GAMMARUS_WILKITZKII	GAMMARUS_WILKITZKII	4
GAM_WIL-ICE_ALG	GAMMARUS_WILKITZKII	ICE_ALGAE	1
GAM_WIL-MET_LON	GAMMARUS_WILKITZKII	METRIDIA_LONGA	2
GAM_WIL-MIC_SPP	GAMMARUS_WILKITZKII	MICROCALANUS_SPP	2
GAM_WIL-OIT_SIM	GAMMARUS_WILKITZKII	OITHONA_SPINIROSTRIS/ATLANTICA	2
GAM_WIL-PROZOO	GAMMARUS_WILKITZKII	PROTOZOOPLANKTON	1
GAS_ACU-CAL_FIN	GASTEROSTEUS_ACULEATUS	CALANUS_FINMARCHICUS	1
GAS_ACU-CAL_GLA	GASTEROSTEUS_ACULEATUS	CALANUS_GLACIALIS	1
GAS_ACU-CAL_HYP	GASTEROSTEUS_ACULEATUS	CALANUS_HYPERBOREUS	1
GAS_ACU-FI_LA	GASTEROSTEUS_ACULEATUS	FISH_LARVAE	1
GEO_SP-BAC_IND	GEODIA_SP	BACTERIA_INDET	1
GEO_SP-DET_IND	GEODIA_SP	DETRITUS	1
GEO_SP-PHY_IND	GEODIA_SP	PHYTOPLANKTON_INDET	1
GLY_CYN-GAM_IND	GLYPTOCEPHALUS_CYNOGLOSSUS	GAMMARIDAE_INDET	1
GLY_CYN-OPH_SP	GLYPTOCEPHALUS_CYNOGLOSSUS	OPHIURA_SP	1
GLY_CYN-POL_IND	GLYPTOCEPHALUS_CYNOGLOSSUS	POLYCHAETA	1
GLY_CYN-SCL_SP	GLYPTOCEPHALUS_CYNOGLOSSUS	SCLEROCRANGON_SP	4
GON_FAB-CAL_FIN	GONATUS_FABRICII	CALANUS_FINMARCHICUS	1
GON_FAB-CAL_GLA	GONATUS_FABRICII	CALANUS_GLACIALIS	2
GON_FAB-CAL_HYP	GONATUS_FABRICII	CALANUS_HYPERBOREUS	1
GON_FAB-GON_FAB	GONATUS_FABRICII	GONATUS_FABRICII	1
GON_FAB-MET_LON	GONATUS_FABRICII	METRIDIA_LONGA	2
GON_FAB-OIT_SIM	GONATUS_FABRICII	OITHONA_SPINIROSTRIS/ATLANTICA	2
GON_FAB-POL_VIR	GONATUS_FABRICII	POLLACHIUS_VIRENS	2
GON_FAB-THE_ABY	GONATUS_FABRICII	THEMISTO_ABYSSORUM	2
GON_FAB-THE_LIB	GONATUS_FABRICII	THEMISTO_LIBELLULA	2
GON_FAB-THY_INE	GONATUS_FABRICII	THYSANOESSA_INERMIS	2
GON_FAB-THY_LON	GONATUS_FABRICII	THYSANOESSA_LONGICAUDATA	2
GON_FAB-THY_RAS	GONATUS_FABRICII	THYSANOESSA_RASCHII	2
GOR_SP-CAL_GLA	GORGONOCEPHALUS_SP	CALANUS_GLACIALIS	4
GOR_SP-FI_LA	GORGONOCEPHALUS_SP	FISH_LARVAE	1
GOR_SP-MEG_NOR	GORGONOCEPHALUS_SP	MEGANYCTIPHANES_NORVEGICA	1
GYM_SP-APH_GLA	GYMNELUS_SPP	APHERUSA_GLACIALIS	3
GYM_SPP-BAL_SP	GYMNELUS_SPP	BALANUS_SP	1
GYM_SPP-CAL_HYP	GYMNELUS_SPP	CALANUS_HYPERBOREUS	4
GYM_SPP-GAM_IND	GYMNELUS_SPP	GAMMARIDAE_INDET	1
GYM_SPP-POL_IND	GYMNELUS_SPP	POLYCHAETA	1
GYM_SPP-PSE_SPP	GYMNELUS_SPP	PSEUDOCALANUS_SPP	1
GYM_SPP-THY_INE	GYMNELUS_SPP	THYSANOESSA_INERMIS	4
GYM_TRI-CAL_HYP	GYMNOCANTHUS_TRICUSPIS	CALANUS_HYPERBOREUS	1
GYM_TRI-MAC_SP	GYMNOCANTHUS_TRICUSPIS	MACOMA_SP	1
GYM_TRI-MAL_SAR	GYMNOCANTHUS_TRICUSPIS	MALDANE_SARSI	2
GYM_TRI-MET_LON	GYMNOCANTHUS_TRICUSPIS	METRIDIA_LONGA	1
GYM_TRI-OIK_VAN	GYMNOCANTHUS_TRICUSPIS	OIKOPLEURA_VANHOEFFENI	1
GYM_TRI-POL_IND	GYMNOCANTHUS_TRICUSPIS	POLYCHAETA	2
GYM_TRI-SCA_INF	GYMNOCANTHUS_TRICUSPIS	SCALIBREGMA_INFLATUM	1
GYM_TRI-SPI_TYP	GYMNOCANTHUS_TRICUSPIS	SPIOCHAETOPTERUS_TYPICUS	2
GYM_TRI-TER_STRO	GYMNOCANTHUS_TRICUSPIS	TEREBELLIDES_STROEMI	2
GYM_TRI-THY_RAS	GYMNOCANTHUS_TRICUSPIS	THYSANOESSA_RASCHII	4
HEL_GLA-DET_IND	HELIOMETRA_GLACIALIS	DETRITUS	4
HEL_GLA-DIATOM	HELIOMETRA_GLACIALIS	DIATOM	4
HET_FIL-DET_IND	HETEROMASTUS_FILIFORMIS	DETRITUS	1
HET_FLA-AUT_FLA	HETEROTROPH_FLAGELLAT	AUTOTHROPH_FLAGELLAT	2
HET_FLA-BAC_IND	HETEROTROPH_FLAGELLAT	BACTERIA_INDET	2
HIP_HIP-AMM_SPP	HIPPOGLOSSUS_HIPPOGLOSSUS	AMMODYTES_SPP	1
HIP_HIP-AST_SP	HIPPOGLOSSUS_HIPPOGLOSSUS	ASTARTE_SP	1
HIP_HIP-GAD_MOR	HIPPOGLOSSUS_HIPPOGLOSSUS	GADUS_MORHUA	1
HIP_HIP-GAM_IND	HIPPOGLOSSUS_HIPPOGLOSSUS	GAMMARIDAE_INDET	1
HIP_HIP-HIP_PLA	HIPPOGLOSSUS_HIPPOGLOSSUS	HIPPOGLOSSOIDES_PLATESSOIDES	4
HIP_HIP-LUM_SP	HIPPOGLOSSUS_HIPPOGLOSSUS	LUMBRINERIS_SP	1
HIP_HIP-MEL_AEG	HIPPOGLOSSUS_HIPPOGLOSSUS	MELANOGRAMMUS_AEGLEFINUS	3
HIP_HIP-MER_MER	HIPPOGLOSSUS_HIPPOGLOSSUS	MERLANGIUS_MERLANGUS	3
HIP_HIP-MIC_POU	HIPPOGLOSSUS_HIPPOGLOSSUS	MICROMESISTIUS_POUTASSOU	3
HIP_HIP-NEP_SP	HIPPOGLOSSUS_HIPPOGLOSSUS	NEPHTHEIDAE_SP	1
HIP_HIP-OPH_ACU	HIPPOGLOSSUS_HIPPOGLOSSUS	OPHIOPHOLIS_ACULEATA	1
HIP_HIP-OPH_SP	HIPPOGLOSSUS_HIPPOGLOSSUS	OPHIURA_SP	1
HIP_HIP-PAG_SP	HIPPOGLOSSUS_HIPPOGLOSSUS	PAGURUS_SP	1
HIP_HIP-PAN_BOR	HIPPOGLOSSUS_HIPPOGLOSSUS	PANDALUS_BOREALIS	1
HIP_HIP-POL_IND	HIPPOGLOSSUS_HIPPOGLOSSUS	POLYCHAETA	1
HIP_HIP-TER_STRO	HIPPOGLOSSUS_HIPPOGLOSSUS	TEREBELLIDES_STROEMI	1
HIP_HIP-TRI_MUR	HIPPOGLOSSUS_HIPPOGLOSSUS	TRIGLOPS_MURRAYI	2
HIP_HIP-YOL_SOL	HIPPOGLOSSUS_HIPPOGLOSSUS	YOLDIELLA_SOLIDULA	1
HIP_PLA-BOR_SAI	HIPPOGLOSSOIDES_PLATESSOIDES	BOREOGADUS_SAIDA	1
HIP_PLA-CLI_LIM	HIPPOGLOSSOIDES_PLATESSOIDES	CLIONE_LIMACINA	1
HIP_PLA-CLU_HAR	HIPPOGLOSSOIDES_PLATESSOIDES	CLUPEA_HARENGUS	1
HIP_PLA-CTE_CRI	HIPPOGLOSSOIDES_PLATESSOIDES	CTENODISCUS_CRISPATUS	1
HIP_PLA-GYM_SPP	HIPPOGLOSSOIDES_PLATESSOIDES	GYMNELUS_SPP	4
HIP_PLA-HYA_SP	HIPPOGLOSSOIDES_PLATESSOIDES	HYAS_SP	1
HIP_PLA-LUM_FAB	HIPPOGLOSSOIDES_PLATESSOIDES	LUMPENUS_FABRICII	4
HIP_PLA-LUM_LAM	HIPPOGLOSSOIDES_PLATESSOIDES	LUMPENUS_LAMPRETAEFORMIS	1
HIP_PLA-LUM_SP	HIPPOGLOSSOIDES_PLATESSOIDES	LUMBRINERIS_SP	4
HIP_PLA-MAL_VIL	HIPPOGLOSSOIDES_PLATESSOIDES	MALLOTUS_VILLOSUS	1
HIP_PLA-OPH_ACU	HIPPOGLOSSOIDES_PLATESSOIDES	OPHIOPHOLIS_ACULEATA	4
HIP_PLA-OPH_BID	HIPPOGLOSSOIDES_PLATESSOIDES	OPHIACANTHA_BIDENTATA	4
HIP_PLA-OPH_SER	HIPPOGLOSSOIDES_PLATESSOIDES	OPHIOCTEN_SERICEUM	4
HIP_PLA-OPH_SP	HIPPOGLOSSOIDES_PLATESSOIDES	OPHIURA_SP	1
HIP_PLA-PAN_BOR	HIPPOGLOSSOIDES_PLATESSOIDES	PANDALUS_BOREALIS	1
HIP_PLA-POL_IND	HIPPOGLOSSOIDES_PLATESSOIDES	POLYCHAETA	1
HIP_PLA-SAB_SP	HIPPOGLOSSOIDES_PLATESSOIDES	SABINEA_SP	1
HIP_PLA-THE_LIB	HIPPOGLOSSOIDES_PLATESSOIDES	THEMISTO_LIBELLULA	4
HIP_PLA-TRI_PIN	HIPPOGLOSSOIDES_PLATESSOIDES	TRIGLOPS_PINGELII	1
HYA_SP-AST_RUB	HYAS_SP	ASTERIAS_RUBENS	2
HYA_SP-CHL_ISL	HYAS_SP	CHLAMYS_ISLANDICA	1
HYD_IND-DET_IND	HYDROZOA_INDET	DETRITUS	4
ICE_SPP-ASC_G_SP	ICELUS_SPP	ASCIDIACEA_G_SP	1
ICE_SPP-CAL_GLA	ICELUS_SPP	CALANUS_GLACIALIS	1
ICE_SPP-CAL_HYP	ICELUS_SPP	CALANUS_HYPERBOREUS	1
ICE_SPP-POL_IND	ICELUS_SPP	POLYCHAETA	2
ICE_SPP-PSE_SPP	ICELUS_SPP	PSEUDOCALANUS_SPP	1
ICE_SPP-RHA_SP	ICELUS_SPP	RHACHOTROPIS_SP	1
ICE_SPP-SAG_SPP	ICELUS_SPP	SAGITTA_SPP	4
ICE_SPP-THY_INE	ICELUS_SPP	THYSANOESSA_INERMIS	1
LAG_ALB-BOR_SAI	LAGENORHYNCHUS_ALBIROSTRIS	BOREOGADUS_SAIDA	1
LAG_ALB-CLU_HAR	LAGENORHYNCHUS_ALBIROSTRIS	CLUPEA_HARENGUS	1
LAG_ALB-GAD_MOR	LAGENORHYNCHUS_ALBIROSTRIS	GADUS_MORHUA	1
LAG_ALB-GON_FAB	LAGENORHYNCHUS_ALBIROSTRIS	GONATUS_FABRICII	1
LAG_ALB-MAL_VIL	LAGENORHYNCHUS_ALBIROSTRIS	MALLOTUS_VILLOSUS	1
LAG_ALB-MEL_AEG	LAGENORHYNCHUS_ALBIROSTRIS	MELANOGRAMMUS_AEGLEFINUS	1
LAG_ALB-MER_MER	LAGENORHYNCHUS_ALBIROSTRIS	MERLANGIUS_MERLANGUS	1
LAG_ALB-SCO_SCO	LAGENORHYNCHUS_ALBIROSTRIS	SCOMBER_SCOMBRUS	4
LAG_ALB-TRI_ESM	LAGENORHYNCHUS_ALBIROSTRIS	TRISOPTERUS_ESMARKII	1
LAR_ARG-ALL_ALL	LARUS_ARGENTATUS	ALLE_ALLE	4
LAR_ARG-AST_RUB	LARUS_ARGENTATUS	ASTERIAS_RUBENS	2
LAR_ARG-BAL_SP	LARUS_ARGENTATUS	BALANUS_SP	2
LAR_ARG-CLU_HAR	LARUS_ARGENTATUS	CLUPEA_HARENGUS	2
LAR_ARG-CRO_PAP	LARUS_ARGENTATUS	CROSSASTER_PAPPOSUS	2
LAR_ARG-GAD_MOR	LARUS_ARGENTATUS	GADUS_MORHUA	2
LAR_ARG-MAL_VIL	LARUS_ARGENTATUS	MALLOTUS_VILLOSUS	1
LAR_HYP-ALL_ALL	LARUS_HYPERBOREUS	ALLE_ALLE	2
LAR_HYP-AMM_SPP	LARUS_HYPERBOREUS	AMMODYTES_SPP	1
LAR_HYP-BOR_SAI	LARUS_HYPERBOREUS	BOREOGADUS_SAIDA	1
LAR_HYP-CLU_HAR	LARUS_HYPERBOREUS	CLUPEA_HARENGUS	2
LAR_HYP-GAD_MOR	LARUS_HYPERBOREUS	GADUS_MORHUA	1
LAR_HYP-MAL_VIL	LARUS_HYPERBOREUS	MALLOTUS_VILLOSUS	2
LAR_HYP-SEB_MAR	LARUS_HYPERBOREUS	SEBASTES_MARINUS	1
LAR_HYP-SEB_MEN	LARUS_HYPERBOREUS	SEBASTES_MENTELLA	1
LAR_MAR-AST_RUB	LARUS_MARINUS	ASTERIAS_RUBENS	2
LAR_MAR-BAL_SP	LARUS_MARINUS	BALANUS_SP	2
LAR_MAR-CLU_HAR	LARUS_MARINUS	CLUPEA_HARENGUS	2
LAR_MAR-GAD_MOR	LARUS_MARINUS	GADUS_MORHUA	2
LAR_MAR-MAL_VIL	LARUS_MARINUS	MALLOTUS_VILLOSUS	1
LEP_DEC-CAL_FIN	LEPTAGONUS_DECAGONUS	CALANUS_FINMARCHICUS	1
LEP_DEC-CAL_GLA	LEPTAGONUS_DECAGONUS	CALANUS_GLACIALIS	1
LEP_DEC-CAL_HYP	LEPTAGONUS_DECAGONUS	CALANUS_HYPERBOREUS	1
LEP_DEC-GAM_IND	LEPTAGONUS_DECAGONUS	GAMMARIDAE_INDET	1
LEP_DEC-MET_LON	LEPTAGONUS_DECAGONUS	METRIDIA_LONGA	1
LEP_DEC-PAR_SPP	LEPTAGONUS_DECAGONUS	PAREUCHAETA_SPP	4
LEP_DEC-POL_IND	LEPTAGONUS_DECAGONUS	POLYCHAETA	1
LEP_DEC-POLY_IND	LEPTAGONUS_DECAGONUS	POLYNOIDAE_INDET	1
LEP_DEC-THE_LIB	LEPTAGONUS_DECAGONUS	THEMISTO_LIBELLULA	1
LEP_DEC-THY_INE	LEPTAGONUS_DECAGONUS	THYSANOESSA_INERMIS	1
LEP_DEC-THY_LON	LEPTAGONUS_DECAGONUS	THYSANOESSA_LONGICAUDATA	1
LEP_MAC-GAM_IND	LEPTOCLINUS_MACULATUS	GAMMARIDAE_INDET	4
LEP_MAC-POL_IND	LEPTOCLINUS_MACULATUS	POLYCHAETA	1
LIM_HEL-APH_GLA	LIMACINA_HELICINA	APHERUSA_GLACIALIS	2
LIM_HEL-CAL_FIN	LIMACINA_HELICINA	CALANUS_FINMARCHICUS	2
LIM_HEL-CAL_GLA	LIMACINA_HELICINA	CALANUS_GLACIALIS	2
LIM_HEL-CAL_HYP	LIMACINA_HELICINA	CALANUS_HYPERBOREUS	2
LIM_HEL-GAM_WIL	LIMACINA_HELICINA	GAMMARUS_WILKITZKII	2
LIM_HEL-MET_LON	LIMACINA_HELICINA	METRIDIA_LONGA	2
LIM_HEL-OIT_SIM	LIMACINA_HELICINA	OITHONA_SPINIROSTRIS/ATLANTICA	2
LIM_HEL-ONI_GLA	LIMACINA_HELICINA	ONISIMUS_GLACIALIS	2
LIM_HEL-ONI_NAN	LIMACINA_HELICINA	ONISIMUS_NANSENI	2
LIM_HEL-PHY_IND	LIMACINA_HELICINA	PHYTOPLANKTON_INDET	1
LIM_HEL-PSE_SPP	LIMACINA_HELICINA	PSEUDOCALANUS_SPP	2
LIM_LIM-AMM_SPP	LIMANDA_LIMANDA	AMMODYTES_SPP	2
LIM_LIM-AST_RUB	LIMANDA_LIMANDA	ASTERIAS_RUBENS	2
LIM_LIM-BAL_SP	LIMANDA_LIMANDA	BALANUS_SP	2
LIM_LIM-BUC_SP	LIMANDA_LIMANDA	BUCCINUM_SP	1
LIM_LIM-CRO_PAP	LIMANDA_LIMANDA	CROSSASTER_PAPPOSUS	2
LIM_LIM-MAC_SP	LIMANDA_LIMANDA	MACOMA_SP	1
LIM_LIM-OPH_ACU	LIMANDA_LIMANDA	OPHIOPHOLIS_ACULEATA	1
LIM_LIM-OPH_BID	LIMANDA_LIMANDA	OPHIACANTHA_BIDENTATA	1
LIM_LIM-OPH_SP	LIMANDA_LIMANDA	OPHIURA_SP	1
LIM_LIM-PAG_SP	LIMANDA_LIMANDA	PAGURUS_SP	1
LIM_LIM-PAN_BOR	LIMANDA_LIMANDA	PANDALUS_BOREALIS	2
LIM_LIM-POL_IND	LIMANDA_LIMANDA	POLYCHAETA	1
LIM_LIM-SCL_SP	LIMANDA_LIMANDA	SCLEROCRANGON_SP	4
LIM_LIM-STRO_SP	LIMANDA_LIMANDA	STRONGYLOCENTROTUS_SP	1
LIM_LIM-TER_STRO	LIMANDA_LIMANDA	TEREBELLIDES_STROEMI	1
LIM_RET-APH_GLA	LIMACINA_RETROVERSA	APHERUSA_GLACIALIS	2
LIM_RET-CAL_FIN	LIMACINA_RETROVERSA	CALANUS_FINMARCHICUS	2
LIM_RET-CAL_GLA	LIMACINA_RETROVERSA	CALANUS_GLACIALIS	2
LIM_RET-CAL_HYP	LIMACINA_RETROVERSA	CALANUS_HYPERBOREUS	2
LIM_RET-GAM_WIL	LIMACINA_RETROVERSA	GAMMARUS_WILKITZKII	2
LIM_RET-MET_LON	LIMACINA_RETROVERSA	METRIDIA_LONGA	2
LIM_RET-OIT_SIM	LIMACINA_RETROVERSA	OITHONA_SPINIROSTRIS/ATLANTICA	2
LIM_RET-ONI_GLA	LIMACINA_RETROVERSA	ONISIMUS_GLACIALIS	2
LIM_RET-ONI_NAN	LIMACINA_RETROVERSA	ONISIMUS_NANSENI	2
LIM_RET-PHY_IND	LIMACINA_RETROVERSA	PHYTOPLANKTON_INDET	4
LIM_RET-PSE_SPP	LIMACINA_RETROVERSA	PSEUDOCALANUS_SPP	2
LIP_FAB-CAL_HYP	LIPARIS_FABRICII	CALANUS_HYPERBOREUS	1
LIP_FAB-MET_LON	LIPARIS_FABRICII	METRIDIA_LONGA	1
LIP_FAB-ONC_BOR	LIPARIS_FABRICII	ONCAEA_BOREALIS	1
LIP_FAB-PSE_SPP	LIPARIS_FABRICII	PSEUDOCALANUS_SPP	1
LIP_GIB-MAL_VIL	LIPARIS_GIBBUS	MALLOTUS_VILLOSUS	1
LIP_GIB-POL_IND	LIPARIS_GIBBUS	POLYCHAETA	1
LIP_GIB-THE_ABY	LIPARIS_GIBBUS	THEMISTO_ABYSSORUM	2
LIP_GIB-THE_LIB	LIPARIS_GIBBUS	THEMISTO_LIBELLULA	2
LIP_MON-CAL_HYP	LIPARIS_MONTAGUI	CALANUS_HYPERBOREUS	4
LIP_MON-GAM_IND	LIPARIS_MONTAGUI	GAMMARIDAE_INDET	4
LIP_MON-OST_IND	LIPARIS_MONTAGUI	OSTRACODA_INDET	1
LIP_MON-PSE_SPP	LIPARIS_MONTAGUI	PSEUDOCALANUS_SPP	4
LUM_FAB-FI_LA	LUMPENUS_FABRICII	FISH_LARVAE	1
LUM_FAB-POL_IND	LUMPENUS_FABRICII	POLYCHAETA	1
LUM_LAM-CAL_FIN	LUMPENUS_LAMPRETAEFORMIS	CALANUS_FINMARCHICUS	4
LUM_LAM-CAL_GLA	LUMPENUS_LAMPRETAEFORMIS	CALANUS_GLACIALIS	4
LUM_LAM-CAL_HYP	LUMPENUS_LAMPRETAEFORMIS	CALANUS_HYPERBOREUS	4
LUM_LAM-DET_IND	LUMPENUS_LAMPRETAEFORMIS	DETRITUS	1
LUM_LAM-FOR_IND	LUMPENUS_LAMPRETAEFORMIS	FORAMINIFERA	1
LUM_LAM-GAM_IND	LUMPENUS_LAMPRETAEFORMIS	GAMMARIDAE_INDET	1
LUM_LAM-OST_IND	LUMPENUS_LAMPRETAEFORMIS	OSTRACODA_INDET	1
LUM_LAM-THY_LON	LUMPENUS_LAMPRETAEFORMIS	THYSANOESSA_LONGICAUDATA	4
LUM_LAM-THY_RAS	LUMPENUS_LAMPRETAEFORMIS	THYSANOESSA_RASCHII	4
LUM_MIN-AUT_FLA	LUMBRICLYMENE_MINOR	AUTOTHROPH_FLAGELLAT	1
LUM_MIN-DET_IND	LUMBRICLYMENE_MINOR	DETRITUS	1
LUM_MIN-DIATOM	LUMBRICLYMENE_MINOR	DIATOM	1
LUM_MIN-HET_FLA	LUMBRICLYMENE_MINOR	HETEROTROPH_FLAGELLAT	1
LUM_MIN-PHY_IND	LUMBRICLYMENE_MINOR	PHYTOPLANKTON_INDET	1
LUM_SP-CIR_IND	LUMBRINERIS_SP	CIRRATULIDAE_INDET	3
LUM_SP-DET_IND	LUMBRINERIS_SP	DETRITUS	1
LUM_SP-HET_FIL	LUMBRINERIS_SP	HETEROMASTUS_FILIFORMIS	3
LUM_SP-LUM_SP	LUMBRINERIS_SP	LUMBRINERIS_SP	3
LUM_SP-OST_IND	LUMBRINERIS_SP	OSTRACODA_INDET	3
LUM_SP-SPI_KRO	LUMBRINERIS_SP	SPIOPHANES_KROEYERI	3
LYC_ESM-BRY_IND	LYCODES_ESMARKII	BRYOZOA_INDET	3
LYC_ESM-DET_IND	LYCODES_ESMARKII	DETRITUS	4
LYC_ESM-GAM_IND	LYCODES_ESMARKII	GAMMARIDAE_INDET	1
LYC_ESM-LUM_SP	LYCODES_ESMARKII	LUMBRINERIS_SP	4
LYC_ESM-OPH_SER	LYCODES_ESMARKII	OPHIOCTEN_SERICEUM	4
LYC_ESM-POL_IND	LYCODES_ESMARKII	POLYCHAETA	4
LYC_ESM-THE_LIB	LYCODES_ESMARKII	THEMISTO_LIBELLULA	4
LYC_ESM-THY_INE	LYCODES_ESMARKII	THYSANOESSA_INERMIS	4
LYC_EUD-OPH_SP	LYCODES_EUDIPLEUROSTICTUS	OPHIURA_SP	4
LYC_EUD-OST_IND	LYCODES_EUDIPLEUROSTICTUS	OSTRACODA_INDET	4
LYC_EUD-POL_IND	LYCODES_EUDIPLEUROSTICTUS	POLYCHAETA	1
LYC_GRA-GAM_IND	LYCODES_GRACILIS	GAMMARIDAE_INDET	4
LYC_GRA-POL_IND	LYCODES_GRACILIS	POLYCHAETA	1
LYC_GRA-YOL_SOL	LYCODES_GRACILIS	YOLDIELLA_SOLIDULA	4
LYC_KOL-GAM_IND	LYCENCHELYS_KOLTHOFFI	GAMMARIDAE_INDET	1
LYC_KOL-MAL_VIL	LYCENCHELYS_KOLTHOFFI	MALLOTUS_VILLOSUS	4
LYC_KOL-MEG_NOR	LYCENCHELYS_KOLTHOFFI	MEGANYCTIPHANES_NORVEGICA	4
LYC_KOL-OPH_ACU	LYCENCHELYS_KOLTHOFFI	OPHIOPHOLIS_ACULEATA	2
LYC_KOL-OPH_SP	LYCENCHELYS_KOLTHOFFI	OPHIURA_SP	4
LYC_PAL-DET_IND	LYCODES_PALLIDUS	DETRITUS	1
LYC_PAL-GAM_IND	LYCODES_PALLIDUS	GAMMARIDAE_INDET	1
LYC_PAL-MEG_NOR	LYCODES_PALLIDUS	MEGANYCTIPHANES_NORVEGICA	4
LYC_PAL-OPH_ACU	LYCODES_PALLIDUS	OPHIOPHOLIS_ACULEATA	4
LYC_PAL-OPH_BID	LYCODES_PALLIDUS	OPHIACANTHA_BIDENTATA	4
LYC_PAL-OPH_SER	LYCODES_PALLIDUS	OPHIOCTEN_SERICEUM	4
LYC_PAL-OPH_SP	LYCODES_PALLIDUS	OPHIURA_SP	4
LYC_PAL-PAN_BOR	LYCODES_PALLIDUS	PANDALUS_BOREALIS	1
LYC_PAL-POL_IND	LYCODES_PALLIDUS	POLYCHAETA	1
LYC_PAL-SCL_SP	LYCODES_PALLIDUS	SCLEROCRANGON_SP	4
LYC_PAL-SPI_TYP	LYCODES_PALLIDUS	SPIOCHAETOPTERUS_TYPICUS	2
LYC_PAL-STRO_SP	LYCODES_PALLIDUS	STRONGYLOCENTROTUS_SP	4
LYC_PAL-TER_STRO	LYCODES_PALLIDUS	TEREBELLIDES_STROEMI	4
LYC_PAL-THE_ABY	LYCODES_PALLIDUS	THEMISTO_ABYSSORUM	4
LYC_PAL-THE_LIB	LYCODES_PALLIDUS	THEMISTO_LIBELLULA	4
LYC_PAL-THY_INE	LYCODES_PALLIDUS	THYSANOESSA_INERMIS	4
LYC_PAL-THY_LON	LYCODES_PALLIDUS	THYSANOESSA_LONGICAUDATA	4
LYC_PAL-THY_RAS	LYCODES_PALLIDUS	THYSANOESSA_RASCHII	4
LYC_PAL-YOL_SOL	LYCODES_PALLIDUS	YOLDIELLA_SOLIDULA	4
LYC_RET-MAL_VIL	LYCODES_RETICULATUS	MALLOTUS_VILLOSUS	1
LYC_RET-MEG_NOR	LYCODES_RETICULATUS	MEGANYCTIPHANES_NORVEGICA	1
LYC_RET-PAN_BOR	LYCODES_RETICULATUS	PANDALUS_BOREALIS	1
LYC_RET-THE_ABY	LYCODES_RETICULATUS	THEMISTO_ABYSSORUM	2
LYC_RET-THE_LIB	LYCODES_RETICULATUS	THEMISTO_LIBELLULA	2
LYC_RET-THY_INE	LYCODES_RETICULATUS	THYSANOESSA_INERMIS	4
LYC_RET-THY_LON	LYCODES_RETICULATUS	THYSANOESSA_LONGICAUDATA	4
LYC_RET-THY_RAS	LYCODES_RETICULATUS	THYSANOESSA_RASCHII	4
LYC_ROS-MEG_NOR	LYCODES_ROSSI	MEGANYCTIPHANES_NORVEGICA	1
LYC_ROS-PAN_BOR	LYCODES_ROSSI	PANDALUS_BOREALIS	1
LYC_ROS-THY_INE	LYCODES_ROSSI	THYSANOESSA_INERMIS	4
LYC_ROS-THY_LON	LYCODES_ROSSI	THYSANOESSA_LONGICAUDATA	4
LYC_SEM-PAN_BOR	LYCODES_SEMINUDUS	PANDALUS_BOREALIS	1
LYC_SEM-THE_ABY	LYCODES_SEMINUDUS	THEMISTO_ABYSSORUM	4
LYC_SEM-THE_LIB	LYCODES_SEMINUDUS	THEMISTO_LIBELLULA	4
LYC_SEM-THY_INE	LYCODES_SEMINUDUS	THYSANOESSA_INERMIS	4
LYC_SEM-THY_RAS	LYCODES_SEMINUDUS	THYSANOESSA_RASCHII	4
MAC_BER-APH_GLA	MACROURUS_BERGLAX	APHERUSA_GLACIALIS	1
MAC_BER-BRO_BRO	MACROURUS_BERGLAX	BROSME_BROSME	1
MAC_BER-CAL_FIN	MACROURUS_BERGLAX	CALANUS_FINMARCHICUS	1
MAC_BER-CIO_INT	MACROURUS_BERGLAX	CIONA_INTESTINALIS	1
MAC_BER-CLU_HAR	MACROURUS_BERGLAX	CLUPEA_HARENGUS	1
MAC_BER-CRO_PAP	MACROURUS_BERGLAX	CROSSASTER_PAPPOSUS	1
MAC_BER-FI_LA	MACROURUS_BERGLAX	FISH_LARVAE	1
MAC_BER-GAM_IND	MACROURUS_BERGLAX	GAMMARIDAE_INDET	1
MAC_BER-MAC_BER	MACROURUS_BERGLAX	MACROURUS_BERGLAX	1
MAC_BER-MEG_NOR	MACROURUS_BERGLAX	MEGANYCTIPHANES_NORVEGICA	1
MAC_BER-OPH_ACU	MACROURUS_BERGLAX	OPHIOPHOLIS_ACULEATA	4
MAC_BER-OPH_BID	MACROURUS_BERGLAX	OPHIACANTHA_BIDENTATA	4
MAC_BER-OPH_BOR	MACROURUS_BERGLAX	OPHIOPLEURA_BOREALIS	4
MAC_BER-OPH_GLA	MACROURUS_BERGLAX	OPHIOSCOLEX_GLACIALIS	1
MAC_BER-OPH_SER	MACROURUS_BERGLAX	OPHIOCTEN_SERICEUM	1
MAC_BER-OPH_SP	MACROURUS_BERGLAX	OPHIURA_SP	1
MAC_BER-OST_IND	MACROURUS_BERGLAX	OSTRACODA_INDET	1
MAC_BER-PAN_BOR	MACROURUS_BERGLAX	PANDALUS_BOREALIS	1
MAC_BER-POL_IND	MACROURUS_BERGLAX	POLYCHAETA	1
MAC_BER-REI_HIP	MACROURUS_BERGLAX	REINHARDTIUS_HIPPOGLOSSOIDES	1
MAC_BER-STRO_SP	MACROURUS_BERGLAX	STRONGYLOCENTROTUS_SP	1
MAC_BER-THY_INE	MACROURUS_BERGLAX	THYSANOESSA_INERMIS	1
MAC_BER-THY_RAS	MACROURUS_BERGLAX	THYSANOESSA_RASCHII	1
MAC_SP-AUT_FLA	MACOMA_SP	AUTOTHROPH_FLAGELLAT	4
MAC_SP-PHY_IND	MACOMA_SP	PHYTOPLANKTON_INDET	4
MAL_SAR-DET_IND	MALDANE_SARSI	DETRITUS	4
MAL_VIL-CAL_FIN	MALLOTUS_VILLOSUS	CALANUS_FINMARCHICUS	1
MAL_VIL-CAL_GLA	MALLOTUS_VILLOSUS	CALANUS_GLACIALIS	2
MAL_VIL-CAL_HYP	MALLOTUS_VILLOSUS	CALANUS_HYPERBOREUS	1
MAL_VIL-MAL_VIL	MALLOTUS_VILLOSUS	MALLOTUS_VILLOSUS	1
MAL_VIL-MET_LON	MALLOTUS_VILLOSUS	METRIDIA_LONGA	1
MAL_VIL-OIK_SPP	MALLOTUS_VILLOSUS	OIKOPLEURA_SPP	1
MAL_VIL-OIT_SIM	MALLOTUS_VILLOSUS	OITHONA_SPINIROSTRIS/ATLANTICA	2
MAL_VIL-ONC_BOR	MALLOTUS_VILLOSUS	ONCAEA_BOREALIS	1
MAL_VIL-PAR_NOR	MALLOTUS_VILLOSUS	PAREUCHAETA_NORVEGICA	1
MAL_VIL-PAR_SPP	MALLOTUS_VILLOSUS	PAREUCHAETA_SPP	1
MAL_VIL-PSE_SPP	MALLOTUS_VILLOSUS	PSEUDOCALANUS_SPP	1
MAL_VIL-THE_ABY	MALLOTUS_VILLOSUS	THEMISTO_ABYSSORUM	1
MAL_VIL-THE_LIB	MALLOTUS_VILLOSUS	THEMISTO_LIBELLULA	1
MAL_VIL-THY_INE	MALLOTUS_VILLOSUS	THYSANOESSA_INERMIS	1
MAL_VIL-THY_RAS	MALLOTUS_VILLOSUS	THYSANOESSA_RASCHII	1
MAU_MUE-ACA_SPP	MAUROLICUS_MUELLERI	ACARTIA_SPP	1
MAU_MUE-FI_LA	MAUROLICUS_MUELLERI	FISH_LARVAE	1
MAU_MUE-MET_LUC	MAUROLICUS_MUELLERI	METRIDIA_LUCENS	1
MAU_MUE-NEM_MEG	MAUROLICUS_MUELLERI	NEMATOSCELIS_MEGALOPS	4
MAU_MUE-ONC_BOR	MAUROLICUS_MUELLERI	ONCAEA_BOREALIS	1
MAU_MUE-OST_IND	MAUROLICUS_MUELLERI	OSTRACODA_INDET	1
MEG_NOR-ACA_SPP	MEGANYCTIPHANES_NORVEGICA	ACARTIA_SPP	1
MEG_NOR-AUT_FLA	MEGANYCTIPHANES_NORVEGICA	AUTOTHROPH_FLAGELLAT	1
MEG_NOR-CAL_FIN	MEGANYCTIPHANES_NORVEGICA	CALANUS_FINMARCHICUS	1
MEG_NOR-CAL_GLA	MEGANYCTIPHANES_NORVEGICA	CALANUS_GLACIALIS	2
MEG_NOR-CAL_HYP	MEGANYCTIPHANES_NORVEGICA	CALANUS_HYPERBOREUS	2
MEG_NOR-DET_IND	MEGANYCTIPHANES_NORVEGICA	DETRITUS	1
MEG_NOR-DIATOM	MEGANYCTIPHANES_NORVEGICA	DIATOM	1
MEG_NOR-FOR_IND	MEGANYCTIPHANES_NORVEGICA	FORAMINIFERA	1
MEG_NOR-HET_FLA	MEGANYCTIPHANES_NORVEGICA	HETEROTROPH_FLAGELLAT	1
MEG_NOR-MET_LON	MEGANYCTIPHANES_NORVEGICA	METRIDIA_LONGA	1
MEG_NOR-MIC_SPP	MEGANYCTIPHANES_NORVEGICA	MICROCALANUS_SPP	2
MEG_NOR-OIT_SIM	MEGANYCTIPHANES_NORVEGICA	OITHONA_SPINIROSTRIS/ATLANTICA	4
MEG_NOR-PSE_SPP	MEGANYCTIPHANES_NORVEGICA	PSEUDOCALANUS_SPP	1
MEG_NOV-AMM_SPP	MEGAPTERA_NOVAEANGLIAE	AMMODYTES_SPP	4
MEG_NOV-BOR_SAI	MEGAPTERA_NOVAEANGLIAE	BOREOGADUS_SAIDA	4
MEG_NOV-CAL_FIN	MEGAPTERA_NOVAEANGLIAE	CALANUS_FINMARCHICUS	2
MEG_NOV-CAL_GLA	MEGAPTERA_NOVAEANGLIAE	CALANUS_GLACIALIS	2
MEG_NOV-CAL_HYP	MEGAPTERA_NOVAEANGLIAE	CALANUS_HYPERBOREUS	2
MEG_NOV-CLU_HAR	MEGAPTERA_NOVAEANGLIAE	CLUPEA_HARENGUS	1
MEG_NOV-FI_LA	MEGAPTERA_NOVAEANGLIAE	FISH_LARVAE	1
MEG_NOV-GAD_MOR	MEGAPTERA_NOVAEANGLIAE	GADUS_MORHUA	4
MEG_NOV-GLY_CYN	MEGAPTERA_NOVAEANGLIAE	GLYPTOCEPHALUS_CYNOGLOSSUS	4
MEG_NOV-MAL_VIL	MEGAPTERA_NOVAEANGLIAE	MALLOTUS_VILLOSUS	1
MEG_NOV-MEG_NOR	MEGAPTERA_NOVAEANGLIAE	MEGANYCTIPHANES_NORVEGICA	1
MEG_NOV-MEL_AEG	MEGAPTERA_NOVAEANGLIAE	MELANOGRAMMUS_AEGLEFINUS	4
MEG_NOV-MIC_POU	MEGAPTERA_NOVAEANGLIAE	MICROMESISTIUS_POUTASSOU	1
MEG_NOV-POL_VIR	MEGAPTERA_NOVAEANGLIAE	POLLACHIUS_VIRENS	4
MEG_NOV-REI_HIP	MEGAPTERA_NOVAEANGLIAE	REINHARDTIUS_HIPPOGLOSSOIDES	2
MEG_NOV-SCO_SCO	MEGAPTERA_NOVAEANGLIAE	SCOMBER_SCOMBRUS	4
MEG_NOV-SEB_MAR	MEGAPTERA_NOVAEANGLIAE	SEBASTES_MARINUS	2
MEG_NOV-SEB_MEN	MEGAPTERA_NOVAEANGLIAE	SEBASTES_MENTELLA	2
MEG_NOV-SEB_SPP	MEGAPTERA_NOVAEANGLIAE	SEBASTES_SPP	4
MEG_NOV-THE_ABY	MEGAPTERA_NOVAEANGLIAE	THEMISTO_ABYSSORUM	4
MEG_NOV-THE_LIB	MEGAPTERA_NOVAEANGLIAE	THEMISTO_LIBELLULA	4
MEG_NOV-THY_INE	MEGAPTERA_NOVAEANGLIAE	THYSANOESSA_INERMIS	1
MEG_NOV-THY_LON	MEGAPTERA_NOVAEANGLIAE	THYSANOESSA_LONGICAUDATA	1
MEG_NOV-THY_RAS	MEGAPTERA_NOVAEANGLIAE	THYSANOESSA_RASCHII	1
MEL_AEG-ACT_G_SP	MELANOGRAMMUS_AEGLEFINUS	ACTINIARIA_G_SP	3
MEL_AEG-AMM_SPP	MELANOGRAMMUS_AEGLEFINUS	AMMODYTES_SPP	1
MEL_AEG-APH_GLA	MELANOGRAMMUS_AEGLEFINUS	APHERUSA_GLACIALIS	4
MEL_AEG-ARC_RIS	MELANOGRAMMUS_AEGLEFINUS	ARCTOZENUS_RISSO	4
MEL_AEG-ARR_PHY	MELANOGRAMMUS_AEGLEFINUS	ARRHIS_PHYLLONYX	4
MEL_AEG-ART_ATL	MELANOGRAMMUS_AEGLEFINUS	ARTEDIELLUS_ATLANTICUS	4
MEL_AEG-AST_RUB	MELANOGRAMMUS_AEGLEFINUS	ASTERIAS_RUBENS	4
MEL_AEG-AST_SP	MELANOGRAMMUS_AEGLEFINUS	ASTARTE_SP	1
MEL_AEG-BAL_SP	MELANOGRAMMUS_AEGLEFINUS	BALANUS_SP	2
MEL_AEG-BAT_GLA	MELANOGRAMMUS_AEGLEFINUS	BATHYARCA_GLACIALIS	4
MEL_AEG-BEN_GLA	MELANOGRAMMUS_AEGLEFINUS	BENTHOSEMA_GLACIALE	2
MEL_AEG-BER_SP	MELANOGRAMMUS_AEGLEFINUS	BEROè_SP	4
MEL_AEG-BOL_INF	MELANOGRAMMUS_AEGLEFINUS	BOLINOPSIS_INFUNDIBULUM	4
MEL_AEG-BOR_SAI	MELANOGRAMMUS_AEGLEFINUS	BOREOGADUS_SAIDA	3
MEL_AEG-BUC_SP	MELANOGRAMMUS_AEGLEFINUS	BUCCINUM_SP	4
MEL_AEG-CAL_FIN	MELANOGRAMMUS_AEGLEFINUS	CALANUS_FINMARCHICUS	1
MEL_AEG-CAL_GLA	MELANOGRAMMUS_AEGLEFINUS	CALANUS_GLACIALIS	2
MEL_AEG-CAL_HYP	MELANOGRAMMUS_AEGLEFINUS	CALANUS_HYPERBOREUS	1
MEL_AEG-CHA_SP	MELANOGRAMMUS_AEGLEFINUS	CHAETOZONE_SP	1
MEL_AEG-CLU_HAR	MELANOGRAMMUS_AEGLEFINUS	CLUPEA_HARENGUS	1
MEL_AEG-COL_SP	MELANOGRAMMUS_AEGLEFINUS	COLUS_SP	4
MEL_AEG-CRO_PAP	MELANOGRAMMUS_AEGLEFINUS	CROSSASTER_PAPPOSUS	4
MEL_AEG-CTE_CRI	MELANOGRAMMUS_AEGLEFINUS	CTENODISCUS_CRISPATUS	1
MEL_AEG-CUC_FRO	MELANOGRAMMUS_AEGLEFINUS	CUCUMARIA_FRONDOSA	4
MEL_AEG-ERY_SP	MELANOGRAMMUS_AEGLEFINUS	ERYTHROPS_SP	1
MEL_AEG-EUK_HAM	MELANOGRAMMUS_AEGLEFINUS	EUKROHNIA_HAMATA	4
MEL_AEG-FI_LA	MELANOGRAMMUS_AEGLEFINUS	FISH_LARVAE	1
MEL_AEG-GAD_MOR	MELANOGRAMMUS_AEGLEFINUS	GADUS_MORHUA	2
MEL_AEG-GAM_IND	MELANOGRAMMUS_AEGLEFINUS	GAMMARIDAE_INDET	1
MEL_AEG-GAM_WIL	MELANOGRAMMUS_AEGLEFINUS	GAMMARUS_WILKITZKII	4
MEL_AEG-HEL_GLA	MELANOGRAMMUS_AEGLEFINUS	HELIOMETRA_GLACIALIS	4
MEL_AEG-HET_FIL	MELANOGRAMMUS_AEGLEFINUS	HETEROMASTUS_FILIFORMIS	1
MEL_AEG-HIP_PLA	MELANOGRAMMUS_AEGLEFINUS	HIPPOGLOSSOIDES_PLATESSOIDES	2
MEL_AEG-HYA_SP	MELANOGRAMMUS_AEGLEFINUS	HYAS_SP	1
MEL_AEG-LEP_DEC	MELANOGRAMMUS_AEGLEFINUS	LEPTAGONUS_DECAGONUS	3
MEL_AEG-LEP_MAC	MELANOGRAMMUS_AEGLEFINUS	LEPTOCLINUS_MACULATUS	2
MEL_AEG-LUM_LAM	MELANOGRAMMUS_AEGLEFINUS	LUMPENUS_LAMPRETAEFORMIS	2
MEL_AEG-MAC_SP	MELANOGRAMMUS_AEGLEFINUS	MACOMA_SP	1
MEL_AEG-MAL_SAR	MELANOGRAMMUS_AEGLEFINUS	MALDANE_SARSI	1
MEL_AEG-MAL_VIL	MELANOGRAMMUS_AEGLEFINUS	MALLOTUS_VILLOSUS	1
MEL_AEG-MEG_NOR	MELANOGRAMMUS_AEGLEFINUS	MEGANYCTIPHANES_NORVEGICA	1
MEL_AEG-MEL_AEG	MELANOGRAMMUS_AEGLEFINUS	MELANOGRAMMUS_AEGLEFINUS	2
MEL_AEG-MEN_FER	MELANOGRAMMUS_AEGLEFINUS	MENDICULA_FERRUGINOSA	4
MEL_AEG-MER_OVU	MELANOGRAMMUS_AEGLEFINUS	MERTENSIA_OVUM	4
MEL_AEG-MET_LON	MELANOGRAMMUS_AEGLEFINUS	METRIDIA_LONGA	1
MEL_AEG-MIC_POU	MELANOGRAMMUS_AEGLEFINUS	MICROMESISTIUS_POUTASSOU	1
MEL_AEG-MOL_BOR	MELANOGRAMMUS_AEGLEFINUS	MOLPADIA_BOREALIS	4
MEL_AEG-MYO_SCO	MELANOGRAMMUS_AEGLEFINUS	MYOXOCEPHALUS_SCORPIUS	4
MEL_AEG-NEP_SP	MELANOGRAMMUS_AEGLEFINUS	NEPHTHEIDAE_SP	1
MEL_AEG-ONI_GLA	MELANOGRAMMUS_AEGLEFINUS	ONISIMUS_GLACIALIS	4
MEL_AEG-ONI_NAN	MELANOGRAMMUS_AEGLEFINUS	ONISIMUS_NANSENI	4
MEL_AEG-OPH_ACU	MELANOGRAMMUS_AEGLEFINUS	OPHIOPHOLIS_ACULEATA	1
MEL_AEG-OPH_BID	MELANOGRAMMUS_AEGLEFINUS	OPHIACANTHA_BIDENTATA	2
MEL_AEG-OPH_BOR	MELANOGRAMMUS_AEGLEFINUS	OPHIOPLEURA_BOREALIS	2
MEL_AEG-OPH_GLA	MELANOGRAMMUS_AEGLEFINUS	OPHIOSCOLEX_GLACIALIS	2
MEL_AEG-OPH_SER	MELANOGRAMMUS_AEGLEFINUS	OPHIOCTEN_SERICEUM	2
MEL_AEG-OPH_SP	MELANOGRAMMUS_AEGLEFINUS	OPHIURA_SP	1
MEL_AEG-OST_IND	MELANOGRAMMUS_AEGLEFINUS	OSTRACODA_INDET	4
MEL_AEG-PAG_SP	MELANOGRAMMUS_AEGLEFINUS	PAGURUS_SP	2
MEL_AEG-PAN_BOR	MELANOGRAMMUS_AEGLEFINUS	PANDALUS_BOREALIS	1
MEL_AEG-POL_IND	MELANOGRAMMUS_AEGLEFINUS	POLYCHAETA	1
MEL_AEG-PON_NOR	MELANOGRAMMUS_AEGLEFINUS	PONTOPHILUS_NORVEGICUS	1
MEL_AEG-PON_TEN	MELANOGRAMMUS_AEGLEFINUS	PONTASTER_TENUISPINUS	4
MEL_AEG-PRI_CIR	MELANOGRAMMUS_AEGLEFINUS	PRIONOSPIO_CIRRIFERA	1
MEL_AEG-RHA_SP	MELANOGRAMMUS_AEGLEFINUS	RHACHOTROPIS_SP	4
MEL_AEG-SAB_SP	MELANOGRAMMUS_AEGLEFINUS	SABINEA_SP	2
MEL_AEG-SAG_SPP	MELANOGRAMMUS_AEGLEFINUS	SAGITTA_SPP	2
MEL_AEG-SEB_MEN	MELANOGRAMMUS_AEGLEFINUS	SEBASTES_MENTELLA	2
MEL_AEG-SEB_SPP	MELANOGRAMMUS_AEGLEFINUS	SEBASTES_SPP	1
MEL_AEG-SIM_GRE	MELANOGRAMMUS_AEGLEFINUS	SIMILIPECTEN_GREENLANDICUS	4
MEL_AEG-SPI_KRO	MELANOGRAMMUS_AEGLEFINUS	SPIOPHANES_KROEYERI	1
MEL_AEG-SPI_TYP	MELANOGRAMMUS_AEGLEFINUS	SPIOCHAETOPTERUS_TYPICUS	1
MEL_AEG-STI_TRE	MELANOGRAMMUS_AEGLEFINUS	STICHOPUS_TREMULUS	4
MEL_AEG-STRO_SP	MELANOGRAMMUS_AEGLEFINUS	STRONGYLOCENTROTUS_SP	1
MEL_AEG-THE_ABY	MELANOGRAMMUS_AEGLEFINUS	THEMISTO_ABYSSORUM	2
MEL_AEG-THE_LIB	MELANOGRAMMUS_AEGLEFINUS	THEMISTO_LIBELLULA	2
MEL_AEG-THY_GOU	MELANOGRAMMUS_AEGLEFINUS	THYASIRA_GOULDI	4
MEL_AEG-THY_INE	MELANOGRAMMUS_AEGLEFINUS	THYSANOESSA_INERMIS	2
MEL_AEG-TRI_ESM	MELANOGRAMMUS_AEGLEFINUS	TRISOPTERUS_ESMARKII	2
MEL_AEG-TRI_MUR	MELANOGRAMMUS_AEGLEFINUS	TRIGLOPS_MURRAYI	4
MEL_AEG-TRI_NYB	MELANOGRAMMUS_AEGLEFINUS	TRIGLOPS_NYBELINI	4
MEL_AEG-TRI_PIN	MELANOGRAMMUS_AEGLEFINUS	TRIGLOPS_PINGELII	1
MEL_AEG-URA_LIN	MELANOGRAMMUS_AEGLEFINUS	URASTERIAS_LINCKII	4
MEL_AEG-YOL_SOL	MELANOGRAMMUS_AEGLEFINUS	YOLDIELLA_SOLIDULA	1
MEN_FER-DET_IND	MENDICULA_FERRUGINOSA	DETRITUS	4
MER_MER-AMM_SPP	MERLANGIUS_MERLANGUS	AMMODYTES_SPP	1
MER_MER-ANA_LUP	MERLANGIUS_MERLANGUS	ANARHICHAS_LUPUS	1
MER_MER-ARG_SP	MERLANGIUS_MERLANGUS	ARGENTINA_SP	4
MER_MER-CIO_INT	MERLANGIUS_MERLANGUS	CIONA_INTESTINALIS	4
MER_MER-CLU_HAR	MERLANGIUS_MERLANGUS	CLUPEA_HARENGUS	1
MER_MER-GAD_ARG	MERLANGIUS_MERLANGUS	GADICULUS_ARGENTEUS	1
MER_MER-GAD_MOR	MERLANGIUS_MERLANGUS	GADUS_MORHUA	1
MER_MER-GAM_IND	MERLANGIUS_MERLANGUS	GAMMARIDAE_INDET	1
MER_MER-GAS_ACU	MERLANGIUS_MERLANGUS	GASTEROSTEUS_ACULEATUS	1
MER_MER-GON_FAB	MERLANGIUS_MERLANGUS	GONATUS_FABRICII	4
MER_MER-HIP_PLA	MERLANGIUS_MERLANGUS	HIPPOGLOSSOIDES_PLATESSOIDES	1
MER_MER-LIM_LIM	MERLANGIUS_MERLANGUS	LIMANDA_LIMANDA	1
MER_MER-MAU_MUE	MERLANGIUS_MERLANGUS	MAUROLICUS_MUELLERI	1
MER_MER-MEL_AEG	MERLANGIUS_MERLANGUS	MELANOGRAMMUS_AEGLEFINUS	1
MER_MER-MER_MER	MERLANGIUS_MERLANGUS	MERLANGIUS_MERLANGUS	1
MER_MER-MIC_KIT	MERLANGIUS_MERLANGUS	MICROSTOMUS_KITT	1
MER_MER-PAN_BOR	MERLANGIUS_MERLANGUS	PANDALUS_BOREALIS	4
MER_MER-POL_IND	MERLANGIUS_MERLANGUS	POLYCHAETA	1
MER_MER-POR_G_SP	MERLANGIUS_MERLANGUS	PORIFERA_G_SP	1
MER_MER-ROS_SP	MERLANGIUS_MERLANGUS	ROSSIA_SP	4
MER_MER-SAG_SPP	MERLANGIUS_MERLANGUS	SAGITTA_SPP	4
MER_MER-SCL_SP	MERLANGIUS_MERLANGUS	SCLEROCRANGON_SP	4
MER_MER-SCO_SCO	MERLANGIUS_MERLANGUS	SCOMBER_SCOMBRUS	1
MER_MER-SEB_VIV	MERLANGIUS_MERLANGUS	SEBASTES_VIVIPARUS	1
MER_MER-THY_INE	MERLANGIUS_MERLANGUS	THYSANOESSA_INERMIS	4
MER_MER-THY_LON	MERLANGIUS_MERLANGUS	THYSANOESSA_LONGICAUDATA	4
MER_MER-THY_RAS	MERLANGIUS_MERLANGUS	THYSANOESSA_RASCHII	4
MER_MER-TRI_ESM	MERLANGIUS_MERLANGUS	TRISOPTERUS_ESMARKII	1
MER_OVU-CAL_FIN	MERTENSIA_OVUM	CALANUS_FINMARCHICUS	2
MER_OVU-CAL_GLA	MERTENSIA_OVUM	CALANUS_GLACIALIS	2
MER_OVU-CAL_HYP	MERTENSIA_OVUM	CALANUS_HYPERBOREUS	2
MER_OVU-MET_LON	MERTENSIA_OVUM	METRIDIA_LONGA	2
MER_OVU-MIC_SPP	MERTENSIA_OVUM	MICROCALANUS_SPP	2
MER_OVU-OIT_SIM	MERTENSIA_OVUM	OITHONA_SPINIROSTRIS/ATLANTICA	2
MER_OVU-PSE_SPP	MERTENSIA_OVUM	PSEUDOCALANUS_SPP	2
MET_LON-PHY_IND	METRIDIA_LONGA	PHYTOPLANKTON_INDET	2
MET_LUC-PHY_IND	METRIDIA_LUCENS	PHYTOPLANKTON_INDET	2
MIC_KIT-ACT_G_SP	MICROSTOMUS_KITT	ACTINIARIA_G_SP	1
MIC_KIT-POL_IND	MICROSTOMUS_KITT	POLYCHAETA	1
MIC_POU-ANA_DEN	MICROMESISTIUS_POUTASSOU	ANARHICHAS_DENTICULATUS	4
MIC_POU-ANA_LUP	MICROMESISTIUS_POUTASSOU	ANARHICHAS_LUPUS	4
MIC_POU-ANA_MIN	MICROMESISTIUS_POUTASSOU	ANARHICHAS_MINOR	4
MIC_POU-AUR_AUR	MICROMESISTIUS_POUTASSOU	AURELIA_AURITA	4
MIC_POU-BOR_SAI	MICROMESISTIUS_POUTASSOU	BOREOGADUS_SAIDA	1
MIC_POU-CAL_FIN	MICROMESISTIUS_POUTASSOU	CALANUS_FINMARCHICUS	1
MIC_POU-CAL_GLA	MICROMESISTIUS_POUTASSOU	CALANUS_GLACIALIS	4
MIC_POU-CAL_HYP	MICROMESISTIUS_POUTASSOU	CALANUS_HYPERBOREUS	1
MIC_POU-CLU_HAR	MICROMESISTIUS_POUTASSOU	CLUPEA_HARENGUS	1
MIC_POU-CYA_CAP	MICROMESISTIUS_POUTASSOU	CYANEA_CAPILLATA	4
MIC_POU-GAD_MOR	MICROMESISTIUS_POUTASSOU	GADUS_MORHUA	1
MIC_POU-GAM_IND	MICROMESISTIUS_POUTASSOU	GAMMARIDAE_INDET	1
MIC_POU-GON_FAB	MICROMESISTIUS_POUTASSOU	GONATUS_FABRICII	1
MIC_POU-HIP_PLA	MICROMESISTIUS_POUTASSOU	HIPPOGLOSSOIDES_PLATESSOIDES	1
MIC_POU-LIM_HEL	MICROMESISTIUS_POUTASSOU	LIMACINA_HELICINA	4
MIC_POU-LIM_RET	MICROMESISTIUS_POUTASSOU	LIMACINA_RETROVERSA	4
MIC_POU-LIP_FAB	MICROMESISTIUS_POUTASSOU	LIPARIS_FABRICII	4
MIC_POU-LIP_GIB	MICROMESISTIUS_POUTASSOU	LIPARIS_GIBBUS	4
MIC_POU-LIP_MON	MICROMESISTIUS_POUTASSOU	LIPARIS_MONTAGUI	4
MIC_POU-LUM_FAB	MICROMESISTIUS_POUTASSOU	LUMPENUS_FABRICII	4
MIC_POU-LUM_LAM	MICROMESISTIUS_POUTASSOU	LUMPENUS_LAMPRETAEFORMIS	4
MIC_POU-MAL_VIL	MICROMESISTIUS_POUTASSOU	MALLOTUS_VILLOSUS	1
MIC_POU-MAU_MUE	MICROMESISTIUS_POUTASSOU	MAUROLICUS_MUELLERI	1
MIC_POU-MEG_NOR	MICROMESISTIUS_POUTASSOU	MEGANYCTIPHANES_NORVEGICA	1
MIC_POU-MEL_AEG	MICROMESISTIUS_POUTASSOU	MELANOGRAMMUS_AEGLEFINUS	1
MIC_POU-MIC_POU	MICROMESISTIUS_POUTASSOU	MICROMESISTIUS_POUTASSOU	1
MIC_POU-OIK_SPP	MICROMESISTIUS_POUTASSOU	OIKOPLEURA_SPP	1
MIC_POU-PAN_BOR	MICROMESISTIUS_POUTASSOU	PANDALUS_BOREALIS	1
MIC_POU-PAR_NOR	MICROMESISTIUS_POUTASSOU	PAREUCHAETA_NORVEGICA	1
MIC_POU-PAR_SPP	MICROMESISTIUS_POUTASSOU	PAREUCHAETA_SPP	1
MIC_POU-POL_VIR	MICROMESISTIUS_POUTASSOU	POLLACHIUS_VIRENS	1
MIC_POU-ROS_SP	MICROMESISTIUS_POUTASSOU	ROSSIA_SP	4
MIC_POU-SAG_SPP	MICROMESISTIUS_POUTASSOU	SAGITTA_SPP	1
MIC_POU-SEB_SPP	MICROMESISTIUS_POUTASSOU	SEBASTES_SPP	1
MIC_POU-THE_ABY	MICROMESISTIUS_POUTASSOU	THEMISTO_ABYSSORUM	1
MIC_POU-THE_LIB	MICROMESISTIUS_POUTASSOU	THEMISTO_LIBELLULA	1
MIC_POU-THY_INE	MICROMESISTIUS_POUTASSOU	THYSANOESSA_INERMIS	1
MIC_POU-THY_LON	MICROMESISTIUS_POUTASSOU	THYSANOESSA_LONGICAUDATA	1
MIC_POU-THY_RAS	MICROMESISTIUS_POUTASSOU	THYSANOESSA_RASCHII	1
MIC_POU-TRI_ESM	MICROMESISTIUS_POUTASSOU	TRISOPTERUS_ESMARKII	1
MIC_SPP-DET_IND	MICROCALANUS_SPP	DETRITUS	2
MIX_FLA-BAC_IND	MIXOTROPH_FLAGELLATES	BACTERIA_INDET	4
MOL_BOR-AUT_FLA	MOLPADIA_BOREALIS	AUTOTHROPH_FLAGELLAT	1
MOL_BOR-DET_IND	MOLPADIA_BOREALIS	DETRITUS	1
MOL_BOR-DIATOM	MOLPADIA_BOREALIS	DIATOM	1
MOL_BOR-HET_FLA	MOLPADIA_BOREALIS	HETEROTROPH_FLAGELLAT	1
MOL_BOR-MAC_IND	MOLPADIA_BOREALIS	MACROALGAE	1
MOL_BOR-PHY_IND	MOLPADIA_BOREALIS	PHYTOPLANKTON_INDET	1
MOL_MOL-ARG_SP	MOLVA_MOLVA	ARGENTINA_SP	2
MOL_MOL-GAD_MOR	MOLVA_MOLVA	GADUS_MORHUA	1
MOL_MOL-GON_FAB	MOLVA_MOLVA	GONATUS_FABRICII	2
MOL_MOL-MIC_POU	MOLVA_MOLVA	MICROMESISTIUS_POUTASSOU	2
MOL_MOL-OPH_ACU	MOLVA_MOLVA	OPHIOPHOLIS_ACULEATA	4
MOL_MOL-OPH_BID	MOLVA_MOLVA	OPHIACANTHA_BIDENTATA	4
MOL_MOL-OPH_SP	MOLVA_MOLVA	OPHIURA_SP	4
MOL_MOL-ROS_SP	MOLVA_MOLVA	ROSSIA_SP	4
MOL_MOL-THY_RAS	MOLVA_MOLVA	THYSANOESSA_RASCHII	4
MOL_MOL-TRI_ESM	MOLVA_MOLVA	TRISOPTERUS_ESMARKII	1
MON_MON-ARC_GLA	MONODON_MONOCEROS	ARCTOGADUS_GLACIALIS	1
MON_MON-BOR_SAI	MONODON_MONOCEROS	BOREOGADUS_SAIDA	1
MON_MON-GON_FAB	MONODON_MONOCEROS	GONATUS_FABRICII	1
MON_MON-MAL_VIL	MONODON_MONOCEROS	MALLOTUS_VILLOSUS	1
MON_MON-PAN_BOR	MONODON_MONOCEROS	PANDALUS_BOREALIS	1
MON_MON-REI_HIP	MONODON_MONOCEROS	REINHARDTIUS_HIPPOGLOSSOIDES	1
MON_MON-SEB_MAR	MONODON_MONOCEROS	SEBASTES_MARINUS	1
MON_MON-SEB_SPP	MONODON_MONOCEROS	SEBASTES_SPP	1
MYO_SCO-CLU_HAR	MYOXOCEPHALUS_SCORPIUS	CLUPEA_HARENGUS	3
MYO_SCO-GAM_IND	MYOXOCEPHALUS_SCORPIUS	GAMMARIDAE_INDET	1
MYO_SCO-GAM_WIL	MYOXOCEPHALUS_SCORPIUS	GAMMARUS_WILKITZKII	1
MYO_SCO-POL_IND	MYOXOCEPHALUS_SCORPIUS	POLYCHAETA	1
MYR_HEE-DET_IND	MYRIOCHELE_HERRI	DETRITUS	3
NEM_MEG-PHY_IND	NEMATOSCELIS_MEGALOPS	PHYTOPLANKTON_INDET	4
NEP_SP-PHY_IND	NEPHTHEIDAE_SP	PHYTOPLANKTON_INDET	4
NYC_COU-DET_IND	NYCTIPHANES_COUCHII	DETRITUS	1
NYC_COU-DIATOM	NYCTIPHANES_COUCHII	DIATOM	1
NYC_COU-PHY_IND	NYCTIPHANES_COUCHII	PHYTOPLANKTON_INDET	1
NYC_COU-SAG_SPP	NYCTIPHANES_COUCHII	SAGITTA_SPP	1
ODO_ROS-AST_SP	ODOBENUS_ROSMARUS	ASTARTE_SP	1
ODO_ROS-BOR_SAI	ODOBENUS_ROSMARUS	BOREOGADUS_SAIDA	1
ODO_ROS-BUC_SP	ODOBENUS_ROSMARUS	BUCCINUM_SP	1
ODO_ROS-CHL_ISL	ODOBENUS_ROSMARUS	CHLAMYS_ISLANDICA	4
ODO_ROS-ERI_BAR	ODOBENUS_ROSMARUS	ERIGNATHUS_BARBATUS	4
ODO_ROS-HYA_SP	ODOBENUS_ROSMARUS	HYAS_SP	4
ODO_ROS-LIP_FAB	ODOBENUS_ROSMARUS	LIPARIS_FABRICII	4
ODO_ROS-LIP_GIB	ODOBENUS_ROSMARUS	LIPARIS_GIBBUS	4
ODO_ROS-LIP_MON	ODOBENUS_ROSMARUS	LIPARIS_MONTAGUI	4
ODO_ROS-MAC_SP	ODOBENUS_ROSMARUS	MACOMA_SP	4
ODO_ROS-MOL_BOR	ODOBENUS_ROSMARUS	MOLPADIA_BOREALIS	4
ODO_ROS-MYO_SCO	ODOBENUS_ROSMARUS	MYOXOCEPHALUS_SCORPIUS	4
ODO_ROS-PAG_GRO	ODOBENUS_ROSMARUS	PAGOPHILUS_GROENLANDICUS	1
ODO_ROS-PAG_SP	ODOBENUS_ROSMARUS	PAGURUS_SP	4
ODO_ROS-PHO_HIS	ODOBENUS_ROSMARUS	PHOCA_HISPIDA	1
ODO_ROS-POL_IND	ODOBENUS_ROSMARUS	POLYCHAETA	1
ODO_ROS-SCL_SP	ODOBENUS_ROSMARUS	SCLEROCRANGON_SP	4
ODO_ROS-STRO_SP	ODOBENUS_ROSMARUS	STRONGYLOCENTROTUS_SP	1
OIK_DIO-BAC_IND	OIKOPLEURA_DIOICA	BACTERIA_INDET	2
OIK_DIO-DIATOM	OIKOPLEURA_DIOICA	DIATOM	2
OIK_DIO-PHY_IND	OIKOPLEURA_DIOICA	PHYTOPLANKTON_INDET	4
OIK_SPP-BAC_IND	OIKOPLEURA_SPP	BACTERIA_INDET	3
OIK_SPP-PHY_IND	OIKOPLEURA_SPP	PHYTOPLANKTON_INDET	1
OIK_VAN-BAC_IND	OIKOPLEURA_VANHOEFFENI	BACTERIA_INDET	3
OIK_VAN-PHY_IND	OIKOPLEURA_VANHOEFFENI	PHYTOPLANKTON_INDET	4
OIT_SIM-DIATOM	OITHONA_SPINIROSTRIS/ATLANTICA	DIATOM	2
OIT_SIM-PHY_IND	OITHONA_SPINIROSTRIS/ATLANTICA	PHYTOPLANKTON_INDET	2
OIT_SPI-PHY_IND	OITHONA_SIMILIS	PHYTOPLANKTON_INDET	4
ONC_BOR-PHY_IND	ONCAEA_BOREALIS	PHYTOPLANKTON_INDET	2
ONI_GLA-BAC_IND	ONISIMUS_GLACIALIS	BACTERIA_INDET	1
ONI_GLA-CAL_FIN	ONISIMUS_GLACIALIS	CALANUS_FINMARCHICUS	1
ONI_GLA-CAL_GLA	ONISIMUS_GLACIALIS	CALANUS_GLACIALIS	1
ONI_GLA-CAL_HYP	ONISIMUS_GLACIALIS	CALANUS_HYPERBOREUS	1
ONI_GLA-DET_IND	ONISIMUS_GLACIALIS	DETRITUS	1
ONI_GLA-ICE_ALG	ONISIMUS_GLACIALIS	ICE_ALGAE	1
ONI_GLA-PROZOO	ONISIMUS_GLACIALIS	PROTOZOOPLANKTON	1
ONI_NAN-BAC_IND	ONISIMUS_NANSENI	BACTERIA_INDET	1
ONI_NAN-DET_IND	ONISIMUS_NANSENI	DETRITUS	1
ONI_NAN-ICE_ALG	ONISIMUS_NANSENI	ICE_ALGAE	1
ONI_NAN-PHY_IND	ONISIMUS_NANSENI	PHYTOPLANKTON_INDET	4
ONI_NAN-PROZOO	ONISIMUS_NANSENI	PROTOZOOPLANKTON	1
OPH_ACU-DET_IND	OPHIOPHOLIS_ACULEATA	DETRITUS	2
OPH_ACU-PHY_IND	OPHIOPHOLIS_ACULEATA	PHYTOPLANKTON_INDET	2
OPH_BID-DET_IND	OPHIACANTHA_BIDENTATA	DETRITUS	1
OPH_BID-FOR_IND	OPHIACANTHA_BIDENTATA	FORAMINIFERA	1
OPH_BID-GAM_IND	OPHIACANTHA_BIDENTATA	GAMMARIDAE_INDET	1
OPH_BOR-DET_IND	OPHIOPLEURA_BOREALIS	DETRITUS	4
OPH_BOR-PHY_IND	OPHIOPLEURA_BOREALIS	PHYTOPLANKTON_INDET	3
OPH_GLA-DET_IND	OPHIOSCOLEX_GLACIALIS	DETRITUS	4
OPH_SER-DET_IND	OPHIOCTEN_SERICEUM	DETRITUS	4
OPH_SP-AGL_MAL	OPHIURA_SP	AGLAOPHAMUS_MALMGRENI	4
OPH_SP-DET_IND	OPHIURA_SP	DETRITUS	2
OPH_SP-GAM_IND	OPHIURA_SP	GAMMARIDAE_INDET	1
OPH_SP-HYA_SP	OPHIURA_SP	HYAS_SP	1
OPH_SP-PHY_IND	OPHIURA_SP	PHYTOPLANKTON_INDET	2
OPH_SP-POL_IND	OPHIURA_SP	POLYCHAETA	1
OPH_SP-POLY_IND	OPHIURA_SP	POLYNOIDAE_INDET	4
ORC_ORC-ALL_ALL	ORCINUS_ORCA	ALLE_ALLE	2
ORC_ORC-CLU_HAR	ORCINUS_ORCA	CLUPEA_HARENGUS	1
ORC_ORC-DEL_LEU	ORCINUS_ORCA	DELPHINAPTERUS_LEUCAS	2
ORC_ORC-FI_LA	ORCINUS_ORCA	FISH_LARVAE	1
ORC_ORC-FUL_GLA	ORCINUS_ORCA	FULMARUS_GLACIALIS	2
ORC_ORC-GAD_MOR	ORCINUS_ORCA	GADUS_MORHUA	1
ORC_ORC-GON_FAB	ORCINUS_ORCA	GONATUS_FABRICII	1
ORC_ORC-LIM_LIM	ORCINUS_ORCA	LIMANDA_LIMANDA	2
ORC_ORC-MON_MON	ORCINUS_ORCA	MONODON_MONOCEROS	2
ORC_ORC-PLE_PLA	ORCINUS_ORCA	PLEURONECTES_PLATESSA	2
ORC_ORC-POL_VIR	ORCINUS_ORCA	POLLACHIUS_VIRENS	2
ORC_ORC-SCO_SCO	ORCINUS_ORCA	SCOMBER_SCOMBRUS	4
OST_IND-AUT_FLA	OSTRACODA_INDET	AUTOTHROPH_FLAGELLAT	1
OST_IND-BEN_LAR	OSTRACODA_INDET	BENTHOS_LARVAE	1
OST_IND-DET_IND	OSTRACODA_INDET	DETRITUS	1
OST_IND-DIATOM	OSTRACODA_INDET	DIATOM	1
OST_IND-FOR_IND	OSTRACODA_INDET	FORAMINIFERA	1
OST_IND-HET_FLA	OSTRACODA_INDET	HETEROTROPH_FLAGELLAT	1
PAG_GRO-AMM_SPP	PAGOPHILUS_GROENLANDICUS	AMMODYTES_SPP	1
PAG_GRO-BOR_SAI	PAGOPHILUS_GROENLANDICUS	BOREOGADUS_SAIDA	1
PAG_GRO-CLU_HAR	PAGOPHILUS_GROENLANDICUS	CLUPEA_HARENGUS	1
PAG_GRO-GAD_MOR	PAGOPHILUS_GROENLANDICUS	GADUS_MORHUA	1
PAG_GRO-GAM_WIL	PAGOPHILUS_GROENLANDICUS	GAMMARUS_WILKITZKII	4
PAG_GRO-GON_FAB	PAGOPHILUS_GROENLANDICUS	GONATUS_FABRICII	1
PAG_GRO-HIP_PLA	PAGOPHILUS_GROENLANDICUS	HIPPOGLOSSOIDES_PLATESSOIDES	1
PAG_GRO-LIP_FAB	PAGOPHILUS_GROENLANDICUS	LIPARIS_FABRICII	4
PAG_GRO-LIP_GIB	PAGOPHILUS_GROENLANDICUS	LIPARIS_GIBBUS	1
PAG_GRO-LIP_MON	PAGOPHILUS_GROENLANDICUS	LIPARIS_MONTAGUI	1
PAG_GRO-MAL_VIL	PAGOPHILUS_GROENLANDICUS	MALLOTUS_VILLOSUS	1
PAG_GRO-MEG_NOR	PAGOPHILUS_GROENLANDICUS	MEGANYCTIPHANES_NORVEGICA	1
PAG_GRO-PAN_BOR	PAGOPHILUS_GROENLANDICUS	PANDALUS_BOREALIS	1
PAG_GRO-PLE_PLA	PAGOPHILUS_GROENLANDICUS	PLEURONECTES_PLATESSA	2
PAG_GRO-POL_VIR	PAGOPHILUS_GROENLANDICUS	POLLACHIUS_VIRENS	2
PAG_GRO-REI_HIP	PAGOPHILUS_GROENLANDICUS	REINHARDTIUS_HIPPOGLOSSOIDES	1
PAG_GRO-SAB_SP	PAGOPHILUS_GROENLANDICUS	SABINEA_SP	1
PAG_GRO-SCA_INF	PAGOPHILUS_GROENLANDICUS	SCALIBREGMA_INFLATUM	1
PAG_GRO-SEB_MAR	PAGOPHILUS_GROENLANDICUS	SEBASTES_MARINUS	2
PAG_GRO-THE_LIB	PAGOPHILUS_GROENLANDICUS	THEMISTO_LIBELLULA	1
PAG_GRO-THY_INE	PAGOPHILUS_GROENLANDICUS	THYSANOESSA_INERMIS	1
PAG_GRO-THY_LON	PAGOPHILUS_GROENLANDICUS	THYSANOESSA_LONGICAUDATA	1
PAG_GRO-THY_RAS	PAGOPHILUS_GROENLANDICUS	THYSANOESSA_RASCHII	1
PAG_SP-DET_IND	PAGURUS_SP	DETRITUS	2
PAG_SP-PHY_IND	PAGURUS_SP	PHYTOPLANKTON_INDET	2
PAN_BOR-ARR_PHY	PANDALUS_BOREALIS	ARRHIS_PHYLLONYX	2
PAN_BOR-BEN_LAR	PANDALUS_BOREALIS	BENTHOS_LARVAE	1
PAN_BOR-CAL_FIN	PANDALUS_BOREALIS	CALANUS_FINMARCHICUS	1
PAN_BOR-CAL_GLA	PANDALUS_BOREALIS	CALANUS_GLACIALIS	4
PAN_BOR-CAL_HYP	PANDALUS_BOREALIS	CALANUS_HYPERBOREUS	1
PAN_BOR-DET_IND	PANDALUS_BOREALIS	DETRITUS	2
PAN_BOR-FOR_IND	PANDALUS_BOREALIS	FORAMINIFERA	4
PAN_BOR-LUM_SP	PANDALUS_BOREALIS	LUMBRINERIS_SP	2
PAN_BOR-MEG_NOR	PANDALUS_BOREALIS	MEGANYCTIPHANES_NORVEGICA	2
PAN_BOR-NYC_COU	PANDALUS_BOREALIS	NYCTIPHANES_COUCHII	2
PAN_BOR-OIT_SIM	PANDALUS_BOREALIS	OITHONA_SPINIROSTRIS/ATLANTICA	2
PAN_BOR-OIT_SPI	PANDALUS_BOREALIS	OITHONA_SIMILIS	4
PAN_BOR-OST_IND	PANDALUS_BOREALIS	OSTRACODA_INDET	4
PAN_BOR-PAN_BOR	PANDALUS_BOREALIS	PANDALUS_BOREALIS	4
PAN_BOR-PAR_JEF	PANDALUS_BOREALIS	PARAMPHINOME_JEFFREYSII	2
PAN_BOR-PHY_IND	PANDALUS_BOREALIS	PHYTOPLANKTON_INDET	2
PAN_BOR-POL_IND	PANDALUS_BOREALIS	POLYCHAETA	4
PAN_BOR-PSE_SPP	PANDALUS_BOREALIS	PSEUDOCALANUS_SPP	1
PAN_BOR-SAG_SPP	PANDALUS_BOREALIS	SAGITTA_SPP	2
PAN_BOR-SPI_TYP	PANDALUS_BOREALIS	SPIOCHAETOPTERUS_TYPICUS	2
PAN_BOR-TER_STRO	PANDALUS_BOREALIS	TEREBELLIDES_STROEMI	4
PAN_BOR-THE_ABY	PANDALUS_BOREALIS	THEMISTO_ABYSSORUM	2
PAN_BOR-THE_LIB	PANDALUS_BOREALIS	THEMISTO_LIBELLULA	2
PAN_BOR-THY_INE	PANDALUS_BOREALIS	THYSANOESSA_INERMIS	2
PAN_BOR-THY_RAS	PANDALUS_BOREALIS	THYSANOESSA_RASCHII	2
PAR_BAT-THE_ABY	PARALIPARIS_BATHYBIUS	THEMISTO_ABYSSORUM	1
PAR_BAT-THE_LIB	PARALIPARIS_BATHYBIUS	THEMISTO_LIBELLULA	3
PAR_CAM-AGL_MAL	PARALITHODES_CAMTSCHATICUS	AGLAOPHAMUS_MALMGRENI	4
PAR_CAM-AMM_SPP	PARALITHODES_CAMTSCHATICUS	AMMODYTES_SPP	1
PAR_CAM-APH_MAR	PARALITHODES_CAMTSCHATICUS	APHELOCHAETA_MARIONI	4
PAR_CAM-ARR_PHY	PARALITHODES_CAMTSCHATICUS	ARRHIS_PHYLLONYX	1
PAR_CAM-ASE_IND	PARALITHODES_CAMTSCHATICUS	ASELLOTA_INDET	4
PAR_CAM-AST_RUB	PARALITHODES_CAMTSCHATICUS	ASTERIAS_RUBENS	1
PAR_CAM-AST_SP	PARALITHODES_CAMTSCHATICUS	ASTARTE_SP	1
PAR_CAM-BAL_SP	PARALITHODES_CAMTSCHATICUS	BALANUS_SP	1
PAR_CAM-BRY_IND	PARALITHODES_CAMTSCHATICUS	BRYOZOA_INDET	1
PAR_CAM-BUC_SP	PARALITHODES_CAMTSCHATICUS	BUCCINUM_SP	1
PAR_CAM-CHA_SP	PARALITHODES_CAMTSCHATICUS	CHAETOZONE_SP	1
PAR_CAM-CHI_OPI	PARALITHODES_CAMTSCHATICUS	CHIONOECETES_OPILIO	1
PAR_CAM-CHL_ISL	PARALITHODES_CAMTSCHATICUS	CHLAMYS_ISLANDICA	1
PAR_CAM-CHO_SP	PARALITHODES_CAMTSCHATICUS	CHONE_SP	1
PAR_CAM-CIO_INT	PARALITHODES_CAMTSCHATICUS	CIONA_INTESTINALIS	1
PAR_CAM-COL_SP	PARALITHODES_CAMTSCHATICUS	COLUS_SP	1
PAR_CAM-CRO_PAP	PARALITHODES_CAMTSCHATICUS	CROSSASTER_PAPPOSUS	1
PAR_CAM-CTE_CRI	PARALITHODES_CAMTSCHATICUS	CTENODISCUS_CRISPATUS	1
PAR_CAM-CYC_LUM	PARALITHODES_CAMTSCHATICUS	CYCLOPTERUS_LUMPUS	1
PAR_CAM-DET_IND	PARALITHODES_CAMTSCHATICUS	DETRITUS	1
PAR_CAM-DIATOM	PARALITHODES_CAMTSCHATICUS	DIATOM	1
PAR_CAM-EUC_IND	PARALITHODES_CAMTSCHATICUS	EUCLYMENINAE_INDET	4
PAR_CAM-FOR_IND	PARALITHODES_CAMTSCHATICUS	FORAMINIFERA	1
PAR_CAM-GAL_SP	PARALITHODES_CAMTSCHATICUS	GALATHOWENIA_SP	4
PAR_CAM-GAM_IND	PARALITHODES_CAMTSCHATICUS	GAMMARIDAE_INDET	1
PAR_CAM-GOR_SP	PARALITHODES_CAMTSCHATICUS	GORGONOCEPHALUS_SP	1
PAR_CAM-HET_FIL	PARALITHODES_CAMTSCHATICUS	HETEROMASTUS_FILIFORMIS	4
PAR_CAM-HYA_SP	PARALITHODES_CAMTSCHATICUS	HYAS_SP	1
PAR_CAM-LUM_MIN	PARALITHODES_CAMTSCHATICUS	LUMBRICLYMENE_MINOR	4
PAR_CAM-LUM_SP	PARALITHODES_CAMTSCHATICUS	LUMBRINERIS_SP	1
PAR_CAM-MAC_IND	PARALITHODES_CAMTSCHATICUS	MACROALGAE	1
PAR_CAM-MAC_SP	PARALITHODES_CAMTSCHATICUS	MACOMA_SP	1
PAR_CAM-MAL_SAR	PARALITHODES_CAMTSCHATICUS	MALDANE_SARSI	1
PAR_CAM-MAL_VIL	PARALITHODES_CAMTSCHATICUS	MALLOTUS_VILLOSUS	1
PAR_CAM-MEN_FER	PARALITHODES_CAMTSCHATICUS	MENDICULA_FERRUGINOSA	4
PAR_CAM-MOL_BOR	PARALITHODES_CAMTSCHATICUS	MOLPADIA_BOREALIS	1
PAR_CAM-OPH_ACU	PARALITHODES_CAMTSCHATICUS	OPHIOPHOLIS_ACULEATA	1
PAR_CAM-OPH_BID	PARALITHODES_CAMTSCHATICUS	OPHIACANTHA_BIDENTATA	1
PAR_CAM-OPH_BOR	PARALITHODES_CAMTSCHATICUS	OPHIOPLEURA_BOREALIS	1
PAR_CAM-OPH_GLA	PARALITHODES_CAMTSCHATICUS	OPHIOSCOLEX_GLACIALIS	1
PAR_CAM-OPH_SER	PARALITHODES_CAMTSCHATICUS	OPHIOCTEN_SERICEUM	1
PAR_CAM-OPH_SP	PARALITHODES_CAMTSCHATICUS	OPHIURA_SP	1
PAR_CAM-OST_IND	PARALITHODES_CAMTSCHATICUS	OSTRACODA_INDET	1
PAR_CAM-PAG_SP	PARALITHODES_CAMTSCHATICUS	PAGURUS_SP	1
PAR_CAM-PAN_BOR	PARALITHODES_CAMTSCHATICUS	PANDALUS_BOREALIS	1
PAR_CAM-PAR_CAM	PARALITHODES_CAMTSCHATICUS	PARALITHODES_CAMTSCHATICUS	1
PAR_CAM-PAR_JEF	PARALITHODES_CAMTSCHATICUS	PARAMPHINOME_JEFFREYSII	4
PAR_CAM-PHA_STR	PARALITHODES_CAMTSCHATICUS	PHASCOLION_STROMBUS	1
PAR_CAM-POLY_IND	PARALITHODES_CAMTSCHATICUS	POLYNOIDAE_INDET	1
PAR_CAM-PON_TEN	PARALITHODES_CAMTSCHATICUS	PONTASTER_TENUISPINUS	1
PAR_CAM-PRI_CIR	PARALITHODES_CAMTSCHATICUS	PRIONOSPIO_CIRRIFERA	4
PAR_CAM-PYC_G_SP	PARALITHODES_CAMTSCHATICUS	PYCNOGONIDA_G_SP	1
PAR_CAM-SCA_INF	PARALITHODES_CAMTSCHATICUS	SCALIBREGMA_INFLATUM	4
PAR_CAM-SCL_SP	PARALITHODES_CAMTSCHATICUS	SCLEROCRANGON_SP	1
PAR_CAM-SIM_GRE	PARALITHODES_CAMTSCHATICUS	SIMILIPECTEN_GREENLANDICUS	1
PAR_CAM-SPI_TYP	PARALITHODES_CAMTSCHATICUS	SPIOCHAETOPTERUS_TYPICUS	1
PAR_CAM-STRO_SP	PARALITHODES_CAMTSCHATICUS	STRONGYLOCENTROTUS_SP	1
PAR_CAM-THY_GOU	PARALITHODES_CAMTSCHATICUS	THYASIRA_GOULDI	1
PAR_CAM-THY_INE	PARALITHODES_CAMTSCHATICUS	THYSANOESSA_INERMIS	4
PAR_CAM-THY_LON	PARALITHODES_CAMTSCHATICUS	THYSANOESSA_LONGICAUDATA	4
PAR_CAM-THY_RAS	PARALITHODES_CAMTSCHATICUS	THYSANOESSA_RASCHII	4
PAR_CAM-URA_LIN	PARALITHODES_CAMTSCHATICUS	URASTERIAS_LINCKII	1
PAR_CAM-YOL_SOL	PARALITHODES_CAMTSCHATICUS	YOLDIELLA_SOLIDULA	1
PAR_GLA-CAL_FIN	PAREUCHAETA_GLACIALIS	CALANUS_FINMARCHICUS	4
PAR_GLA-CAL_GLA	PAREUCHAETA_GLACIALIS	CALANUS_GLACIALIS	4
PAR_GLA-CAL_HYP	PAREUCHAETA_GLACIALIS	CALANUS_HYPERBOREUS	4
PAR_GLA-MET_LON	PAREUCHAETA_GLACIALIS	METRIDIA_LONGA	4
PAR_GLA-MET_LUC	PAREUCHAETA_GLACIALIS	METRIDIA_LUCENS	4
PAR_JEF-DET_IND	PARAMPHINOME_JEFFREYSII	DETRITUS	4
PAR_NOR-CAL_FIN	PAREUCHAETA_NORVEGICA	CALANUS_FINMARCHICUS	4
PAR_NOR-CAL_GLA	PAREUCHAETA_NORVEGICA	CALANUS_GLACIALIS	4
PAR_NOR-CAL_HYP	PAREUCHAETA_NORVEGICA	CALANUS_HYPERBOREUS	4
PAR_NOR-MET_LON	PAREUCHAETA_NORVEGICA	METRIDIA_LONGA	4
PAR_NOR-MET_LUC	PAREUCHAETA_NORVEGICA	METRIDIA_LUCENS	4
PAR_SPP-CAL_FIN	PAREUCHAETA_SPP	CALANUS_FINMARCHICUS	4
PAR_SPP-CAL_GLA	PAREUCHAETA_SPP	CALANUS_GLACIALIS	4
PAR_SPP-CAL_HYP	PAREUCHAETA_SPP	CALANUS_HYPERBOREUS	4
PAR_SPP-MET_LON	PAREUCHAETA_SPP	METRIDIA_LONGA	4
PAR_SPP-MET_LUC	PAREUCHAETA_SPP	METRIDIA_LUCENS	4
PAR_SPP-PSE_SPP	PAREUCHAETA_SPP	PSEUDOCALANUS_SPP	3
PHA_STR-DET_IND	PHASCOLION_STROMBUS	DETRITUS	4
PHA_STR-DIATOM	PHASCOLION_STROMBUS	DIATOM	4
PHO_HIS-AMM_SPP	PHOCA_HISPIDA	AMMODYTES_SPP	1
PHO_HIS-ANI_MED	PHOCA_HISPIDA	ANISARCHUS_MEDIUS	4
PHO_HIS-ARC_GLA	PHOCA_HISPIDA	ARCTOGADUS_GLACIALIS	1
PHO_HIS-AST_SP	PHOCA_HISPIDA	ASTARTE_SP	1
PHO_HIS-BOR_SAI	PHOCA_HISPIDA	BOREOGADUS_SAIDA	1
PHO_HIS-FOR_IND	PHOCA_HISPIDA	FORAMINIFERA	1
PHO_HIS-GAD_MOR	PHOCA_HISPIDA	GADUS_MORHUA	1
PHO_HIS-GAM_WIL	PHOCA_HISPIDA	GAMMARUS_WILKITZKII	1
PHO_HIS-GON_FAB	PHOCA_HISPIDA	GONATUS_FABRICII	1
PHO_HIS-HIP_PLA	PHOCA_HISPIDA	HIPPOGLOSSOIDES_PLATESSOIDES	1
PHO_HIS-LIP_FAB	PHOCA_HISPIDA	LIPARIS_FABRICII	1
PHO_HIS-LIP_GIB	PHOCA_HISPIDA	LIPARIS_GIBBUS	1
PHO_HIS-LIP_MON	PHOCA_HISPIDA	LIPARIS_MONTAGUI	1
PHO_HIS-LYC_ESM	PHOCA_HISPIDA	LYCODES_ESMARKII	1
PHO_HIS-LYC_GRA	PHOCA_HISPIDA	LYCODES_GRACILIS	4
PHO_HIS-LYC_RET	PHOCA_HISPIDA	LYCODES_RETICULATUS	1
PHO_HIS-LYC_SEM	PHOCA_HISPIDA	LYCODES_SEMINUDUS	1
PHO_HIS-MAL_VIL	PHOCA_HISPIDA	MALLOTUS_VILLOSUS	4
PHO_HIS-MEL_AEG	PHOCA_HISPIDA	MELANOGRAMMUS_AEGLEFINUS	1
PHO_HIS-MET_LON	PHOCA_HISPIDA	METRIDIA_LONGA	4
PHO_HIS-ONI_GLA	PHOCA_HISPIDA	ONISIMUS_GLACIALIS	1
PHO_HIS-PAN_BOR	PHOCA_HISPIDA	PANDALUS_BOREALIS	1
PHO_HIS-SAB_SP	PHOCA_HISPIDA	SABINEA_SP	1
PHO_HIS-SCL_SP	PHOCA_HISPIDA	SCLEROCRANGON_SP	1
PHO_HIS-SEB_MAR	PHOCA_HISPIDA	SEBASTES_MARINUS	2
PHO_HIS-SEB_MEN	PHOCA_HISPIDA	SEBASTES_MENTELLA	2
PHO_HIS-SEB_SPP	PHOCA_HISPIDA	SEBASTES_SPP	1
PHO_HIS-THE_LIB	PHOCA_HISPIDA	THEMISTO_LIBELLULA	1
PHO_HIS-THY_INE	PHOCA_HISPIDA	THYSANOESSA_INERMIS	1
PHO_HIS-THY_LON	PHOCA_HISPIDA	THYSANOESSA_LONGICAUDATA	1
PHO_HIS-THY_RAS	PHOCA_HISPIDA	THYSANOESSA_RASCHII	1
PHO_HIS-YOL_SOL	PHOCA_HISPIDA	YOLDIELLA_SOLIDULA	4
PHO_PHO-AMM_SPP	PHOCOENA_PHOCOENA	AMMODYTES_SPP	1
PHO_PHO-ANA_LUP	PHOCOENA_PHOCOENA	ANARHICHAS_LUPUS	1
PHO_PHO-ARG_SP	PHOCOENA_PHOCOENA	ARGENTINA_SP	1
PHO_PHO-ART_ATL	PHOCOENA_PHOCOENA	ARTEDIELLUS_ATLANTICUS	1
PHO_PHO-BOR_SAI	PHOCOENA_PHOCOENA	BOREOGADUS_SAIDA	1
PHO_PHO-CLU_HAR	PHOCOENA_PHOCOENA	CLUPEA_HARENGUS	1
PHO_PHO-FI_LA	PHOCOENA_PHOCOENA	FISH_LARVAE	1
PHO_PHO-GAD_ARG	PHOCOENA_PHOCOENA	GADICULUS_ARGENTEUS	1
PHO_PHO-GAD_MOR	PHOCOENA_PHOCOENA	GADUS_MORHUA	1
PHO_PHO-GON_FAB	PHOCOENA_PHOCOENA	GONATUS_FABRICII	1
PHO_PHO-HIP_PLA	PHOCOENA_PHOCOENA	HIPPOGLOSSOIDES_PLATESSOIDES	1
PHO_PHO-LEP_MAC	PHOCOENA_PHOCOENA	LEPTOCLINUS_MACULATUS	1
PHO_PHO-LIP_MON	PHOCOENA_PHOCOENA	LIPARIS_MONTAGUI	1
PHO_PHO-LUM_LAM	PHOCOENA_PHOCOENA	LUMPENUS_LAMPRETAEFORMIS	1
PHO_PHO-MAL_VIL	PHOCOENA_PHOCOENA	MALLOTUS_VILLOSUS	1
PHO_PHO-MAU_MUE	PHOCOENA_PHOCOENA	MAUROLICUS_MUELLERI	1
PHO_PHO-MEG_NOR	PHOCOENA_PHOCOENA	MEGANYCTIPHANES_NORVEGICA	4
PHO_PHO-MEL_AEG	PHOCOENA_PHOCOENA	MELANOGRAMMUS_AEGLEFINUS	1
PHO_PHO-MER_MER	PHOCOENA_PHOCOENA	MERLANGIUS_MERLANGUS	1
PHO_PHO-MIC_KIT	PHOCOENA_PHOCOENA	MICROSTOMUS_KITT	1
PHO_PHO-MIC_POU	PHOCOENA_PHOCOENA	MICROMESISTIUS_POUTASSOU	1
PHO_PHO-MOL_MOL	PHOCOENA_PHOCOENA	MOLVA_MOLVA	1
PHO_PHO-PAN_BOR	PHOCOENA_PHOCOENA	PANDALUS_BOREALIS	4
PHO_PHO-PLE_PLA	PHOCOENA_PHOCOENA	PLEURONECTES_PLATESSA	1
PHO_PHO-POL_POL	PHOCOENA_PHOCOENA	POLLACHIUS_POLLACHIUS	1
PHO_PHO-POL_VIR	PHOCOENA_PHOCOENA	POLLACHIUS_VIRENS	4
PHO_PHO-ROS_SP	PHOCOENA_PHOCOENA	ROSSIA_SP	1
PHO_PHO-SCO_SCO	PHOCOENA_PHOCOENA	SCOMBER_SCOMBRUS	4
PHO_PHO-SEB_MAR	PHOCOENA_PHOCOENA	SEBASTES_MARINUS	1
PHO_PHO-THY_INE	PHOCOENA_PHOCOENA	THYSANOESSA_INERMIS	4
PHO_PHO-THY_LON	PHOCOENA_PHOCOENA	THYSANOESSA_LONGICAUDATA	4
PHO_PHO-THY_RAS	PHOCOENA_PHOCOENA	THYSANOESSA_RASCHII	4
PHO_PHO-TRI_ESM	PHOCOENA_PHOCOENA	TRISOPTERUS_ESMARKII	2
PHY_MAC-GON_FAB	PHYSETER_MACROCEPHALUS	GONATUS_FABRICII	1
PHY_MAC-POL_VIR	PHYSETER_MACROCEPHALUS	POLLACHIUS_VIRENS	1
PLE_PLA-AMM_SPP	PLEURONECTES_PLATESSA	AMMODYTES_SPP	1
PLE_PLA-AST_RUB	PLEURONECTES_PLATESSA	ASTERIAS_RUBENS	1
PLE_PLA-AST_SP	PLEURONECTES_PLATESSA	ASTARTE_SP	1
PLE_PLA-BAL_SP	PLEURONECTES_PLATESSA	BALANUS_SP	1
PLE_PLA-BUC_SP	PLEURONECTES_PLATESSA	BUCCINUM_SP	1
PLE_PLA-CHL_ISL	PLEURONECTES_PLATESSA	CHLAMYS_ISLANDICA	1
PLE_PLA-CUC_FRO	PLEURONECTES_PLATESSA	CUCUMARIA_FRONDOSA	3
PLE_PLA-FI_LA	PLEURONECTES_PLATESSA	FISH_LARVAE	1
PLE_PLA-GAM_IND	PLEURONECTES_PLATESSA	GAMMARIDAE_INDET	3
PLE_PLA-GAM_WIL	PLEURONECTES_PLATESSA	GAMMARUS_WILKITZKII	2
PLE_PLA-LUM_SP	PLEURONECTES_PLATESSA	LUMBRINERIS_SP	4
PLE_PLA-MAC_SP	PLEURONECTES_PLATESSA	MACOMA_SP	1
PLE_PLA-MAL_SAR	PLEURONECTES_PLATESSA	MALDANE_SARSI	1
PLE_PLA-MEG_NOR	PLEURONECTES_PLATESSA	MEGANYCTIPHANES_NORVEGICA	1
PLE_PLA-MEL_AEG	PLEURONECTES_PLATESSA	MELANOGRAMMUS_AEGLEFINUS	4
PLE_PLA-OPH_ACU	PLEURONECTES_PLATESSA	OPHIOPHOLIS_ACULEATA	1
PLE_PLA-OPH_SP	PLEURONECTES_PLATESSA	OPHIURA_SP	1
PLE_PLA-OST_IND	PLEURONECTES_PLATESSA	OSTRACODA_INDET	1
PLE_PLA-PAG_SP	PLEURONECTES_PLATESSA	PAGURUS_SP	1
PLE_PLA-PAN_BOR	PLEURONECTES_PLATESSA	PANDALUS_BOREALIS	4
PLE_PLA-POL_IND	PLEURONECTES_PLATESSA	POLYCHAETA	1
PLE_PLA-SPI_TYP	PLEURONECTES_PLATESSA	SPIOCHAETOPTERUS_TYPICUS	1
PLE_PLA-STRO_SP	PLEURONECTES_PLATESSA	STRONGYLOCENTROTUS_SP	1
PLE_PLA-TER_STRO	PLEURONECTES_PLATESSA	TEREBELLIDES_STROEMI	1
PLE_PLA-THY_GOU	PLEURONECTES_PLATESSA	THYASIRA_GOULDI	1
PLE_PLA-THY_INE	PLEURONECTES_PLATESSA	THYSANOESSA_INERMIS	3
PLE_PLA-THY_LON	PLEURONECTES_PLATESSA	THYSANOESSA_LONGICAUDATA	3
PLE_PLA-THY_RAS	PLEURONECTES_PLATESSA	THYSANOESSA_RASCHII	3
PLE_PLA-TRI_ESM	PLEURONECTES_PLATESSA	TRISOPTERUS_ESMARKII	4
PLE_PLA-YOL_SOL	PLEURONECTES_PLATESSA	YOLDIELLA_SOLIDULA	4
POL_IND-DET_IND	POLYCHAETA	DETRITUS	4
POL_POL-AMM_SPP	POLLACHIUS_POLLACHIUS	AMMODYTES_SPP	1
POL_POL-CAL_FIN	POLLACHIUS_POLLACHIUS	CALANUS_FINMARCHICUS	4
POL_POL-CAL_GLA	POLLACHIUS_POLLACHIUS	CALANUS_GLACIALIS	4
POL_POL-CAL_HYP	POLLACHIUS_POLLACHIUS	CALANUS_HYPERBOREUS	4
POL_POL-CLU_HAR	POLLACHIUS_POLLACHIUS	CLUPEA_HARENGUS	1
POL_POL-FI_LA	POLLACHIUS_POLLACHIUS	FISH_LARVAE	1
POL_POL-GAD_MOR	POLLACHIUS_POLLACHIUS	GADUS_MORHUA	4
POL_POL-GON_FAB	POLLACHIUS_POLLACHIUS	GONATUS_FABRICII	4
POL_POL-MEG_NOR	POLLACHIUS_POLLACHIUS	MEGANYCTIPHANES_NORVEGICA	1
POL_POL-MEL_AEG	POLLACHIUS_POLLACHIUS	MELANOGRAMMUS_AEGLEFINUS	1
POL_POL-MET_LON	POLLACHIUS_POLLACHIUS	METRIDIA_LONGA	4
POL_POL-MIC_SPP	POLLACHIUS_POLLACHIUS	MICROCALANUS_SPP	4
POL_POL-OIT_SIM	POLLACHIUS_POLLACHIUS	OITHONA_SPINIROSTRIS/ATLANTICA	4
POL_POL-PAN_BOR	POLLACHIUS_POLLACHIUS	PANDALUS_BOREALIS	1
POL_POL-ROS_SP	POLLACHIUS_POLLACHIUS	ROSSIA_SP	4
POL_POL-THY_LON	POLLACHIUS_POLLACHIUS	THYSANOESSA_LONGICAUDATA	4
POL_POL-THY_RAS	POLLACHIUS_POLLACHIUS	THYSANOESSA_RASCHII	4
POL_POL-TRI_ESM	POLLACHIUS_POLLACHIUS	TRISOPTERUS_ESMARKII	1
POL_VIR-ACA_SPP	POLLACHIUS_VIRENS	ACARTIA_SPP	1
POL_VIR-AMM_SPP	POLLACHIUS_VIRENS	AMMODYTES_SPP	1
POL_VIR-ARC_RIS	POLLACHIUS_VIRENS	ARCTOZENUS_RISSO	4
POL_VIR-ARG_SP	POLLACHIUS_VIRENS	ARGENTINA_SP	4
POL_VIR-BAL_SP	POLLACHIUS_VIRENS	BALANUS_SP	1
POL_VIR-CAL_FIN	POLLACHIUS_VIRENS	CALANUS_FINMARCHICUS	1
POL_VIR-CAL_GLA	POLLACHIUS_VIRENS	CALANUS_GLACIALIS	2
POL_VIR-CAL_HYP	POLLACHIUS_VIRENS	CALANUS_HYPERBOREUS	1
POL_VIR-CLU_HAR	POLLACHIUS_VIRENS	CLUPEA_HARENGUS	1
POL_VIR-GAD_ARG	POLLACHIUS_VIRENS	GADICULUS_ARGENTEUS	1
POL_VIR-GAD_MOR	POLLACHIUS_VIRENS	GADUS_MORHUA	1
POL_VIR-GLY_CYN	POLLACHIUS_VIRENS	GLYPTOCEPHALUS_CYNOGLOSSUS	1
POL_VIR-HIP_PLA	POLLACHIUS_VIRENS	HIPPOGLOSSOIDES_PLATESSOIDES	1
POL_VIR-HYA_SP	POLLACHIUS_VIRENS	HYAS_SP	1
POL_VIR-MAL_VIL	POLLACHIUS_VIRENS	MALLOTUS_VILLOSUS	1
POL_VIR-MAU_MUE	POLLACHIUS_VIRENS	MAUROLICUS_MUELLERI	1
POL_VIR-MEG_NOR	POLLACHIUS_VIRENS	MEGANYCTIPHANES_NORVEGICA	1
POL_VIR-MEL_AEG	POLLACHIUS_VIRENS	MELANOGRAMMUS_AEGLEFINUS	1
POL_VIR-MET_LON	POLLACHIUS_VIRENS	METRIDIA_LONGA	1
POL_VIR-MIC_POU	POLLACHIUS_VIRENS	MICROMESISTIUS_POUTASSOU	1
POL_VIR-MYO_SCO	POLLACHIUS_VIRENS	MYOXOCEPHALUS_SCORPIUS	1
POL_VIR-OIT_SIM	POLLACHIUS_VIRENS	OITHONA_SPINIROSTRIS/ATLANTICA	1
POL_VIR-OST_IND	POLLACHIUS_VIRENS	OSTRACODA_INDET	1
POL_VIR-PAN_BOR	POLLACHIUS_VIRENS	PANDALUS_BOREALIS	1
POL_VIR-POL_VIR	POLLACHIUS_VIRENS	POLLACHIUS_VIRENS	1
POL_VIR-PSE_SPP	POLLACHIUS_VIRENS	PSEUDOCALANUS_SPP	1
POL_VIR-SEB_SPP	POLLACHIUS_VIRENS	SEBASTES_SPP	1
POL_VIR-THE_ABY	POLLACHIUS_VIRENS	THEMISTO_ABYSSORUM	4
POL_VIR-THE_LIB	POLLACHIUS_VIRENS	THEMISTO_LIBELLULA	4
POL_VIR-THY_INE	POLLACHIUS_VIRENS	THYSANOESSA_INERMIS	1
POL_VIR-THY_LON	POLLACHIUS_VIRENS	THYSANOESSA_LONGICAUDATA	1
POL_VIR-THY_RAS	POLLACHIUS_VIRENS	THYSANOESSA_RASCHII	1
POL_VIR-TRI_ESM	POLLACHIUS_VIRENS	TRISOPTERUS_ESMARKII	1
POLY_IND-BRY_IND	POLYNOIDAE_INDET	BRYOZOA_INDET	1
POLY_IND-CHO_SP	POLYNOIDAE_INDET	CHONE_SP	1
POLY_IND-DET_IND	POLYNOIDAE_INDET	DETRITUS	1
POLY_IND-DIATOM	POLYNOIDAE_INDET	DIATOM	1
POLY_IND-FOR_IND	POLYNOIDAE_INDET	FORAMINIFERA	1
POLY_IND-GAM_IND	POLYNOIDAE_INDET	GAMMARIDAE_INDET	1
POLY_IND-LUM_SP	POLYNOIDAE_INDET	LUMBRINERIS_SP	1
POLY_IND-MOL_BOR	POLYNOIDAE_INDET	MOLPADIA_BOREALIS	4
POLY_IND-OST_IND	POLYNOIDAE_INDET	OSTRACODA_INDET	1
POLY_IND-POL_IND	POLYNOIDAE_INDET	POLYCHAETA	1
POLY_IND-POLY_IND	POLYNOIDAE_INDET	POLYNOIDAE_INDET	1
POLY_IND-POR_G_SP	POLYNOIDAE_INDET	PORIFERA_G_SP	1
PON_NOR-CAL_FIN	PONTOPHILUS_NORVEGICUS	CALANUS_FINMARCHICUS	2
PON_NOR-CAL_GLA	PONTOPHILUS_NORVEGICUS	CALANUS_GLACIALIS	2
PON_NOR-CAL_HYP	PONTOPHILUS_NORVEGICUS	CALANUS_HYPERBOREUS	2
PON_NOR-MET_LON	PONTOPHILUS_NORVEGICUS	METRIDIA_LONGA	2
PON_NOR-MIC_SPP	PONTOPHILUS_NORVEGICUS	MICROCALANUS_SPP	2
PON_NOR-OIT_SIM	PONTOPHILUS_NORVEGICUS	OITHONA_SPINIROSTRIS/ATLANTICA	2
PON_TEN-DET_IND	PONTASTER_TENUISPINUS	DETRITUS	4
PON_TEN-DIATOM	PONTASTER_TENUISPINUS	DIATOM	4
POR_G_SP-BAC_IND	PORIFERA_G_SP	BACTERIA_INDET	1
POR_G_SP-PHY_IND	PORIFERA_G_SP	PHYTOPLANKTON_INDET	1
PRI_CIR-DET_IND	PRIONOSPIO_CIRRIFERA	DETRITUS	4
PRI_CIR-DIATOM	PRIONOSPIO_CIRRIFERA	DIATOM	4
PROZOO-AUT_FLA	PROTOZOOPLANKTON	AUTOTHROPH_FLAGELLAT	2
PROZOO-BAC_IND	PROTOZOOPLANKTON	BACTERIA_INDET	2
PROZOO-HET_FLA	PROTOZOOPLANKTON	HETEROTROPH_FLAGELLAT	2
PROZOO-MIX_FLA	PROTOZOOPLANKTON	MIXOTROPH_FLAGELLATES	4
PROZOO-PHY_IND	PROTOZOOPLANKTON	PHYTOPLANKTON_INDET	4
PROZOO-PROZOO	PROTOZOOPLANKTON	PROTOZOOPLANKTON	2
PSE_SPP-DET_IND	PSEUDOCALANUS_SPP	DETRITUS	1
PSE_SPP-DIATOM	PSEUDOCALANUS_SPP	DIATOM	2
PSE_SPP-PSE_SPP	PSEUDOCALANUS_SPP	PSEUDOCALANUS_SPP	2
PYC_G_SP-BRY_IND	PYCNOGONIDA_G_SP	BRYOZOA_INDET	4
PYC_G_SP-DET_IND	PYCNOGONIDA_G_SP	DETRITUS	1
PYC_G_SP-ELE_ARC	PYCNOGONIDA_G_SP	ELECTRA_ARCTICA	4
PYC_G_SP-GEO_SP	PYCNOGONIDA_G_SP	GEODIA_SP	1
PYC_G_SP-PHY_IND	PYCNOGONIDA_G_SP	PHYTOPLANKTON_INDET	4
PYC_G_SP-POL_IND	PYCNOGONIDA_G_SP	POLYCHAETA	1
PYC_G_SP-POR_G_SP	PYCNOGONIDA_G_SP	PORIFERA_G_SP	1
RAJ_FYL-MAL_VIL	RAJELLA_FYLLAE	MALLOTUS_VILLOSUS	1
RAJ_FYL-PAN_BOR	RAJELLA_FYLLAE	PANDALUS_BOREALIS	1
RAJ_FYL-PAR_CAM	RAJELLA_FYLLAE	PARALITHODES_CAMTSCHATICUS	2
RAJ_FYL-SAB_SP	RAJELLA_FYLLAE	SABINEA_SP	2
RAJ_FYL-THY_INE	RAJELLA_FYLLAE	THYSANOESSA_INERMIS	2
RAJ_FYL-THY_LON	RAJELLA_FYLLAE	THYSANOESSA_LONGICAUDATA	2
RAJ_FYL-THY_RAS	RAJELLA_FYLLAE	THYSANOESSA_RASCHII	2
REI_HIP-AMM_SPP	REINHARDTIUS_HIPPOGLOSSOIDES	AMMODYTES_SPP	1
REI_HIP-ARC_RIS	REINHARDTIUS_HIPPOGLOSSOIDES	ARCTOZENUS_RISSO	4
REI_HIP-BOR_SAI	REINHARDTIUS_HIPPOGLOSSOIDES	BOREOGADUS_SAIDA	1
REI_HIP-CLU_HAR	REINHARDTIUS_HIPPOGLOSSOIDES	CLUPEA_HARENGUS	1
REI_HIP-COT_MIC	REINHARDTIUS_HIPPOGLOSSOIDES	COTTUNCULUS_MICROPS	1
REI_HIP-ENC_CIM	REINHARDTIUS_HIPPOGLOSSOIDES	ENCHELYOPUS_CIMBRIUS	4
REI_HIP-GAD_MOR	REINHARDTIUS_HIPPOGLOSSOIDES	GADUS_MORHUA	1
REI_HIP-GAI_ARG	REINHARDTIUS_HIPPOGLOSSOIDES	GAIDROPSARUS_ARGENTATUS	1
REI_HIP-GAM_IND	REINHARDTIUS_HIPPOGLOSSOIDES	GAMMARIDAE_INDET	1
REI_HIP-GON_FAB	REINHARDTIUS_HIPPOGLOSSOIDES	GONATUS_FABRICII	1
REI_HIP-HIP_HIP	REINHARDTIUS_HIPPOGLOSSOIDES	HIPPOGLOSSUS_HIPPOGLOSSUS	4
REI_HIP-HIP_PLA	REINHARDTIUS_HIPPOGLOSSOIDES	HIPPOGLOSSOIDES_PLATESSOIDES	1
REI_HIP-LYC_SEM	REINHARDTIUS_HIPPOGLOSSOIDES	LYCODES_SEMINUDUS	1
REI_HIP-MAL_VIL	REINHARDTIUS_HIPPOGLOSSOIDES	MALLOTUS_VILLOSUS	1
REI_HIP-MEG_NOR	REINHARDTIUS_HIPPOGLOSSOIDES	MEGANYCTIPHANES_NORVEGICA	1
REI_HIP-MIC_POU	REINHARDTIUS_HIPPOGLOSSOIDES	MICROMESISTIUS_POUTASSOU	1
REI_HIP-OPH_SP	REINHARDTIUS_HIPPOGLOSSOIDES	OPHIURA_SP	1
REI_HIP-PAN_BOR	REINHARDTIUS_HIPPOGLOSSOIDES	PANDALUS_BOREALIS	1
REI_HIP-POL_IND	REINHARDTIUS_HIPPOGLOSSOIDES	POLYCHAETA	1
REI_HIP-PON_NOR	REINHARDTIUS_HIPPOGLOSSOIDES	PONTOPHILUS_NORVEGICUS	1
REI_HIP-POR_G_SP	REINHARDTIUS_HIPPOGLOSSOIDES	PORIFERA_G_SP	1
REI_HIP-REI_HIP	REINHARDTIUS_HIPPOGLOSSOIDES	REINHARDTIUS_HIPPOGLOSSOIDES	1
REI_HIP-SAB_SP	REINHARDTIUS_HIPPOGLOSSOIDES	SABINEA_SP	1
REI_HIP-SEB_MAR	REINHARDTIUS_HIPPOGLOSSOIDES	SEBASTES_MARINUS	2
REI_HIP-SEB_MEN	REINHARDTIUS_HIPPOGLOSSOIDES	SEBASTES_MENTELLA	1
REI_HIP-SEB_SPP	REINHARDTIUS_HIPPOGLOSSOIDES	SEBASTES_SPP	1
REI_HIP-THE_LIB	REINHARDTIUS_HIPPOGLOSSOIDES	THEMISTO_LIBELLULA	1
RHA_SP-DET_IND	RHACHOTROPIS_SP	DETRITUS	4
RHA_SP-DIATOM	RHACHOTROPIS_SP	DIATOM	4
RHA_SP-PHY_IND	RHACHOTROPIS_SP	PHYTOPLANKTON_INDET	4
RIS_TRI-BOR_SAI	RISSA_TRIDACTYLA	BOREOGADUS_SAIDA	1
RIS_TRI-GAD_MOR	RISSA_TRIDACTYLA	GADUS_MORHUA	1
RIS_TRI-GON_FAB	RISSA_TRIDACTYLA	GONATUS_FABRICII	1
RIS_TRI-MAL_VIL	RISSA_TRIDACTYLA	MALLOTUS_VILLOSUS	1
RIS_TRI-MEG_NOR	RISSA_TRIDACTYLA	MEGANYCTIPHANES_NORVEGICA	4
RIS_TRI-ROS_SP	RISSA_TRIDACTYLA	ROSSIA_SP	4
RIS_TRI-SEB_MAR	RISSA_TRIDACTYLA	SEBASTES_MARINUS	1
RIS_TRI-SEB_MEN	RISSA_TRIDACTYLA	SEBASTES_MENTELLA	1
RIS_TRI-THY_INE	RISSA_TRIDACTYLA	THYSANOESSA_INERMIS	4
RIS_TRI-THY_LON	RISSA_TRIDACTYLA	THYSANOESSA_LONGICAUDATA	4
RIS_TRI-THY_RAS	RISSA_TRIDACTYLA	THYSANOESSA_RASCHII	4
ROS_SP-ARR_PHY	ROSSIA_SP	ARRHIS_PHYLLONYX	4
ROS_SP-FI_LA	ROSSIA_SP	FISH_LARVAE	1
ROS_SP-POL_IND	ROSSIA_SP	POLYCHAETA	1
ROS_SP-RHA_SP	ROSSIA_SP	RHACHOTROPIS_SP	4
ROS_SP-SCL_SP	ROSSIA_SP	SCLEROCRANGON_SP	3
SAB_SP-CAL_FIN	SABINEA_SP	CALANUS_FINMARCHICUS	2
SAB_SP-CAL_GLA	SABINEA_SP	CALANUS_GLACIALIS	2
SAB_SP-CAL_HYP	SABINEA_SP	CALANUS_HYPERBOREUS	2
SAB_SP-MET_LON	SABINEA_SP	METRIDIA_LONGA	2
SAB_SP-MIC_SPP	SABINEA_SP	MICROCALANUS_SPP	2
SAB_SP-OIT_SIM	SABINEA_SP	OITHONA_SPINIROSTRIS/ATLANTICA	2
SAB_SP-PHY_IND	SABINEA_SP	PHYTOPLANKTON_INDET	1
SAG_SPP-ACA_SPP	SAGITTA_SPP	ACARTIA_SPP	1
SAG_SPP-AUT_FLA	SAGITTA_SPP	AUTOTHROPH_FLAGELLAT	1
SAG_SPP-CAL_FIN	SAGITTA_SPP	CALANUS_FINMARCHICUS	1
SAG_SPP-CAL_GLA	SAGITTA_SPP	CALANUS_GLACIALIS	2
SAG_SPP-CAL_HYP	SAGITTA_SPP	CALANUS_HYPERBOREUS	2
SAG_SPP-CLI_LIM	SAGITTA_SPP	CLIONE_LIMACINA	4
SAG_SPP-EUC_IND	SAGITTA_SPP	EUCLYMENINAE_INDET	1
SAG_SPP-FI_LA	SAGITTA_SPP	FISH_LARVAE	4
SAG_SPP-FOR_IND	SAGITTA_SPP	FORAMINIFERA	1
SAG_SPP-LIM_HEL	SAGITTA_SPP	LIMACINA_HELICINA	1
SAG_SPP-LIM_RET	SAGITTA_SPP	LIMACINA_RETROVERSA	4
SAG_SPP-MET_LON	SAGITTA_SPP	METRIDIA_LONGA	2
SAG_SPP-OIK_SPP	SAGITTA_SPP	OIKOPLEURA_SPP	1
SAG_SPP-OIT_SIM	SAGITTA_SPP	OITHONA_SPINIROSTRIS/ATLANTICA	1
SAG_SPP-PHY_IND	SAGITTA_SPP	PHYTOPLANKTON_INDET	3
SAG_SPP-PSE_SPP	SAGITTA_SPP	PSEUDOCALANUS_SPP	1
SAR_SPP-ACA_SPP	SARSIA_SPP	ACARTIA_SPP	1
SAR_SPP-CAL_FIN	SARSIA_SPP	CALANUS_FINMARCHICUS	1
SAR_SPP-OIT_SIM	SARSIA_SPP	OITHONA_SPINIROSTRIS/ATLANTICA	1
SAR_SPP-PSE_SPP	SARSIA_SPP	PSEUDOCALANUS_SPP	1
SAR_SPP-SAG_SPP	SARSIA_SPP	SAGITTA_SPP	4
SCA_INF-DET_IND	SCALIBREGMA_INFLATUM	DETRITUS	4
SCA_INF-DIATOM	SCALIBREGMA_INFLATUM	DIATOM	4
SCL_SP-AUT_FLA	SCLEROCRANGON_SP	AUTOTHROPH_FLAGELLAT	1
SCL_SP-BAL_SP	SCLEROCRANGON_SP	BALANUS_SP	4
SCL_SP-HYD_IND	SCLEROCRANGON_SP	HYDROZOA_INDET	4
SCL_SP-OPH_ACU	SCLEROCRANGON_SP	OPHIOPHOLIS_ACULEATA	4
SCL_SP-OPH_BOR	SCLEROCRANGON_SP	OPHIOPLEURA_BOREALIS	4
SCL_SP-OPH_GLA	SCLEROCRANGON_SP	OPHIOSCOLEX_GLACIALIS	4
SCL_SP-OPH_SP	SCLEROCRANGON_SP	OPHIURA_SP	4
SCL_SP-POL_IND	SCLEROCRANGON_SP	POLYCHAETA	1
SCL_SP-STRO_SP	SCLEROCRANGON_SP	STRONGYLOCENTROTUS_SP	2
SCO_SCO-ACA_SPP	SCOMBER_SCOMBRUS	ACARTIA_SPP	1
SCO_SCO-AMM_SPP	SCOMBER_SCOMBRUS	AMMODYTES_SPP	1
SCO_SCO-APH_GLA	SCOMBER_SCOMBRUS	APHERUSA_GLACIALIS	1
SCO_SCO-ARG_SP	SCOMBER_SCOMBRUS	ARGENTINA_SP	1
SCO_SCO-CAL_FIN	SCOMBER_SCOMBRUS	CALANUS_FINMARCHICUS	1
SCO_SCO-CLI_LIM	SCOMBER_SCOMBRUS	CLIONE_LIMACINA	4
SCO_SCO-FI_LA	SCOMBER_SCOMBRUS	FISH_LARVAE	1
SCO_SCO-GAM_IND	SCOMBER_SCOMBRUS	GAMMARIDAE_INDET	1
SCO_SCO-LIM_HEL	SCOMBER_SCOMBRUS	LIMACINA_HELICINA	1
SCO_SCO-LIM_RET	SCOMBER_SCOMBRUS	LIMACINA_RETROVERSA	1
SCO_SCO-MEG_NOR	SCOMBER_SCOMBRUS	MEGANYCTIPHANES_NORVEGICA	1
SCO_SCO-MIC_POU	SCOMBER_SCOMBRUS	MICROMESISTIUS_POUTASSOU	1
SCO_SCO-NYC_COU	SCOMBER_SCOMBRUS	NYCTIPHANES_COUCHII	1
SCO_SCO-PAN_BOR	SCOMBER_SCOMBRUS	PANDALUS_BOREALIS	1
SCO_SCO-THE_ABY	SCOMBER_SCOMBRUS	THEMISTO_ABYSSORUM	1
SCO_SCO-THE_LIB	SCOMBER_SCOMBRUS	THEMISTO_LIBELLULA	4
SCO_SCO-THY_INE	SCOMBER_SCOMBRUS	THYSANOESSA_INERMIS	4
SCO_SCO-THY_LON	SCOMBER_SCOMBRUS	THYSANOESSA_LONGICAUDATA	4
SCO_SCO-THY_RAS	SCOMBER_SCOMBRUS	THYSANOESSA_RASCHII	4
SEB_MAR-CAL_HYP	SEBASTES_MARINUS	CALANUS_HYPERBOREUS	1
SEB_MAR-CLU_HAR	SEBASTES_MARINUS	CLUPEA_HARENGUS	1
SEB_MAR-GAD_MOR	SEBASTES_MARINUS	GADUS_MORHUA	1
SEB_MAR-MAL_VIL	SEBASTES_MARINUS	MALLOTUS_VILLOSUS	1
SEB_MAR-MEG_NOR	SEBASTES_MARINUS	MEGANYCTIPHANES_NORVEGICA	1
SEB_MAR-MER_OVU	SEBASTES_MARINUS	MERTENSIA_OVUM	4
SEB_MAR-PAN_BOR	SEBASTES_MARINUS	PANDALUS_BOREALIS	1
SEB_MAR-REI_HIP	SEBASTES_MARINUS	REINHARDTIUS_HIPPOGLOSSOIDES	2
SEB_MAR-THY_INE	SEBASTES_MARINUS	THYSANOESSA_INERMIS	1
SEB_MAR-THY_LON	SEBASTES_MARINUS	THYSANOESSA_LONGICAUDATA	2
SEB_MAR-THY_RAS	SEBASTES_MARINUS	THYSANOESSA_RASCHII	2
SEB_MEN-ACT_G_SP	SEBASTES_MENTELLA	ACTINIARIA_G_SP	1
SEB_MEN-APH_GLA	SEBASTES_MENTELLA	APHERUSA_GLACIALIS	4
SEB_MEN-ARC_RIS	SEBASTES_MENTELLA	ARCTOZENUS_RISSO	4
SEB_MEN-ARR_PHY	SEBASTES_MENTELLA	ARRHIS_PHYLLONYX	4
SEB_MEN-AST_SP	SEBASTES_MENTELLA	ASTARTE_SP	4
SEB_MEN-BAT_GLA	SEBASTES_MENTELLA	BATHYARCA_GLACIALIS	4
SEB_MEN-BER_SP	SEBASTES_MENTELLA	BEROè_SP	4
SEB_MEN-BOL_INF	SEBASTES_MENTELLA	BOLINOPSIS_INFUNDIBULUM	4
SEB_MEN-BOR_SAI	SEBASTES_MENTELLA	BOREOGADUS_SAIDA	2
SEB_MEN-CAL_FIN	SEBASTES_MENTELLA	CALANUS_FINMARCHICUS	1
SEB_MEN-CAL_GLA	SEBASTES_MENTELLA	CALANUS_GLACIALIS	1
SEB_MEN-CAL_HYP	SEBASTES_MENTELLA	CALANUS_HYPERBOREUS	1
SEB_MEN-CLI_LIM	SEBASTES_MENTELLA	CLIONE_LIMACINA	1
SEB_MEN-CLU_HAR	SEBASTES_MENTELLA	CLUPEA_HARENGUS	2
SEB_MEN-CUC_FRO	SEBASTES_MENTELLA	CUCUMARIA_FRONDOSA	4
SEB_MEN-FI_LA	SEBASTES_MENTELLA	FISH_LARVAE	4
SEB_MEN-GAD_MOR	SEBASTES_MENTELLA	GADUS_MORHUA	2
SEB_MEN-GAM_IND	SEBASTES_MENTELLA	GAMMARIDAE_INDET	4
SEB_MEN-GAM_WIL	SEBASTES_MENTELLA	GAMMARUS_WILKITZKII	4
SEB_MEN-HIP_PLA	SEBASTES_MENTELLA	HIPPOGLOSSOIDES_PLATESSOIDES	2
SEB_MEN-HYA_SP	SEBASTES_MENTELLA	HYAS_SP	1
SEB_MEN-LIM_HEL	SEBASTES_MENTELLA	LIMACINA_HELICINA	1
SEB_MEN-LIM_RET	SEBASTES_MENTELLA	LIMACINA_RETROVERSA	1
SEB_MEN-MAC_SP	SEBASTES_MENTELLA	MACOMA_SP	4
SEB_MEN-MAL_VIL	SEBASTES_MENTELLA	MALLOTUS_VILLOSUS	1
SEB_MEN-MEG_NOR	SEBASTES_MENTELLA	MEGANYCTIPHANES_NORVEGICA	2
SEB_MEN-MEL_AEG	SEBASTES_MENTELLA	MELANOGRAMMUS_AEGLEFINUS	1
SEB_MEN-MEN_FER	SEBASTES_MENTELLA	MENDICULA_FERRUGINOSA	4
SEB_MEN-MER_OVU	SEBASTES_MENTELLA	MERTENSIA_OVUM	4
SEB_MEN-MET_LON	SEBASTES_MENTELLA	METRIDIA_LONGA	2
SEB_MEN-MIC_POU	SEBASTES_MENTELLA	MICROMESISTIUS_POUTASSOU	1
SEB_MEN-MIC_SPP	SEBASTES_MENTELLA	MICROCALANUS_SPP	4
SEB_MEN-MOL_BOR	SEBASTES_MENTELLA	MOLPADIA_BOREALIS	4
SEB_MEN-OIK_DIO	SEBASTES_MENTELLA	OIKOPLEURA_DIOICA	1
SEB_MEN-OIK_SPP	SEBASTES_MENTELLA	OIKOPLEURA_SPP	1
SEB_MEN-OIK_VAN	SEBASTES_MENTELLA	OIKOPLEURA_VANHOEFFENI	1
SEB_MEN-OIT_SIM	SEBASTES_MENTELLA	OITHONA_SPINIROSTRIS/ATLANTICA	4
SEB_MEN-ONI_GLA	SEBASTES_MENTELLA	ONISIMUS_GLACIALIS	4
SEB_MEN-ONI_NAN	SEBASTES_MENTELLA	ONISIMUS_NANSENI	4
SEB_MEN-PAN_BOR	SEBASTES_MENTELLA	PANDALUS_BOREALIS	1
SEB_MEN-PAR_GLA	SEBASTES_MENTELLA	PAREUCHAETA_GLACIALIS	4
SEB_MEN-PAR_NOR	SEBASTES_MENTELLA	PAREUCHAETA_NORVEGICA	1
SEB_MEN-PAR_SPP	SEBASTES_MENTELLA	PAREUCHAETA_SPP	4
SEB_MEN-POL_VIR	SEBASTES_MENTELLA	POLLACHIUS_VIRENS	2
SEB_MEN-PSE_SPP	SEBASTES_MENTELLA	PSEUDOCALANUS_SPP	2
SEB_MEN-RHA_SP	SEBASTES_MENTELLA	RHACHOTROPIS_SP	4
SEB_MEN-SAG_SPP	SEBASTES_MENTELLA	SAGITTA_SPP	1
SEB_MEN-SEB_MAR	SEBASTES_MENTELLA	SEBASTES_MARINUS	2
SEB_MEN-SEB_MEN	SEBASTES_MENTELLA	SEBASTES_MENTELLA	2
SEB_MEN-SEB_SPP	SEBASTES_MENTELLA	SEBASTES_SPP	2
SEB_MEN-SEB_VIV	SEBASTES_MENTELLA	SEBASTES_VIVIPARUS	2
SEB_MEN-STI_TRE	SEBASTES_MENTELLA	STICHOPUS_TREMULUS	4
SEB_MEN-THE_ABY	SEBASTES_MENTELLA	THEMISTO_ABYSSORUM	4
SEB_MEN-THE_LIB	SEBASTES_MENTELLA	THEMISTO_LIBELLULA	4
SEB_MEN-THY_GOU	SEBASTES_MENTELLA	THYASIRA_GOULDI	4
SEB_MEN-THY_INE	SEBASTES_MENTELLA	THYSANOESSA_INERMIS	2
SEB_MEN-THY_LON	SEBASTES_MENTELLA	THYSANOESSA_LONGICAUDATA	2
SEB_MEN-THY_RAS	SEBASTES_MENTELLA	THYSANOESSA_RASCHII	2
SEB_MEN-YOL_SOL	SEBASTES_MENTELLA	YOLDIELLA_SOLIDULA	4
SEB_SPP-AMM_SPP	SEBASTES_SPP	AMMODYTES_SPP	2
SEB_SPP-CAL_FIN	SEBASTES_SPP	CALANUS_FINMARCHICUS	1
SEB_SPP-CLI_LIM	SEBASTES_SPP	CLIONE_LIMACINA	1
SEB_SPP-GAM_IND	SEBASTES_SPP	GAMMARIDAE_INDET	2
SEB_SPP-MEG_NOR	SEBASTES_SPP	MEGANYCTIPHANES_NORVEGICA	2
SEB_SPP-MET_LON	SEBASTES_SPP	METRIDIA_LONGA	2
SEB_SPP-OIK_SPP	SEBASTES_SPP	OIKOPLEURA_SPP	2
SEB_SPP-OIK_VAN	SEBASTES_SPP	OIKOPLEURA_VANHOEFFENI	4
SEB_SPP-PAN_BOR	SEBASTES_SPP	PANDALUS_BOREALIS	1
SEB_SPP-PAR_NOR	SEBASTES_SPP	PAREUCHAETA_NORVEGICA	2
SEB_SPP-POL_IND	SEBASTES_SPP	POLYCHAETA	1
SEB_SPP-REI_HIP	SEBASTES_SPP	REINHARDTIUS_HIPPOGLOSSOIDES	4
SEB_SPP-SAG_SPP	SEBASTES_SPP	SAGITTA_SPP	1
SEB_SPP-THE_ABY	SEBASTES_SPP	THEMISTO_ABYSSORUM	1
SEB_SPP-THE_LIB	SEBASTES_SPP	THEMISTO_LIBELLULA	1
SEB_SPP-THY_INE	SEBASTES_SPP	THYSANOESSA_INERMIS	1
SEB_VIV-CAL_FIN	SEBASTES_VIVIPARUS	CALANUS_FINMARCHICUS	4
SEB_VIV-GAM_IND	SEBASTES_VIVIPARUS	GAMMARIDAE_INDET	3
SEB_VIV-PAN_BOR	SEBASTES_VIVIPARUS	PANDALUS_BOREALIS	3
SEB_VIV-PYC_G_SP	SEBASTES_VIVIPARUS	PYCNOGONIDA_G_SP	3
SEB_VIV-THE_ABY	SEBASTES_VIVIPARUS	THEMISTO_ABYSSORUM	3
SEB_VIV-THE_LIB	SEBASTES_VIVIPARUS	THEMISTO_LIBELLULA	3
SEB_VIV-THY_INE	SEBASTES_VIVIPARUS	THYSANOESSA_INERMIS	3
SIM_GRE-DET_IND	SIMILIPECTEN_GREENLANDICUS	DETRITUS	4
SIM_GRE-DIATOM	SIMILIPECTEN_GREENLANDICUS	DIATOM	4
SIM_GRE-PHY_IND	SIMILIPECTEN_GREENLANDICUS	PHYTOPLANKTON_INDET	3
SOM_MIC-ANA_DEN	SOMNIOSUS_MICROCEPHALUS	ANARHICHAS_DENTICULATUS	1
SOM_MIC-ANA_LUP	SOMNIOSUS_MICROCEPHALUS	ANARHICHAS_LUPUS	1
SOM_MIC-ANA_MIN	SOMNIOSUS_MICROCEPHALUS	ANARHICHAS_MINOR	1
SOM_MIC-ARG_SP	SOMNIOSUS_MICROCEPHALUS	ARGENTINA_SP	4
SOM_MIC-ART_ATL	SOMNIOSUS_MICROCEPHALUS	ARTEDIELLUS_ATLANTICUS	1
SOM_MIC-ASC_G_SP	SOMNIOSUS_MICROCEPHALUS	ASCIDIACEA_G_SP	1
SOM_MIC-AUR_AUR	SOMNIOSUS_MICROCEPHALUS	AURELIA_AURITA	1
SOM_MIC-BAL_ACU	SOMNIOSUS_MICROCEPHALUS	BALAENOPTERA_ACUTOROSTRATA	1
SOM_MIC-BOL_INF	SOMNIOSUS_MICROCEPHALUS	BOLINOPSIS_INFUNDIBULUM	1
SOM_MIC-BOR_SAI	SOMNIOSUS_MICROCEPHALUS	BOREOGADUS_SAIDA	1
SOM_MIC-BRO_BRO	SOMNIOSUS_MICROCEPHALUS	BROSME_BROSME	1
SOM_MIC-CAR_SPP	SOMNIOSUS_MICROCEPHALUS	CAREPROCTUS_SP	1
SOM_MIC-CLU_HAR	SOMNIOSUS_MICROCEPHALUS	CLUPEA_HARENGUS	1
SOM_MIC-COT_MIC	SOMNIOSUS_MICROCEPHALUS	COTTUNCULUS_MICROPS	1
SOM_MIC-CYC_LUM	SOMNIOSUS_MICROCEPHALUS	CYCLOPTERUS_LUMPUS	1
SOM_MIC-CYS_CRI	SOMNIOSUS_MICROCEPHALUS	CYSTOPHORA_CRISTATA	4
SOM_MIC-ERI_BAR	SOMNIOSUS_MICROCEPHALUS	ERIGNATHUS_BARBATUS	1
SOM_MIC-EUP_FLAM	SOMNIOSUS_MICROCEPHALUS	EUPHYSA_FLAMMEA	1
SOM_MIC-GAD_MOR	SOMNIOSUS_MICROCEPHALUS	GADUS_MORHUA	1
SOM_MIC-GON_FAB	SOMNIOSUS_MICROCEPHALUS	GONATUS_FABRICII	1
SOM_MIC-GOR_SP	SOMNIOSUS_MICROCEPHALUS	GORGONOCEPHALUS_SP	1
SOM_MIC-HIP_HIP	SOMNIOSUS_MICROCEPHALUS	HIPPOGLOSSUS_HIPPOGLOSSUS	1
SOM_MIC-HIP_PLA	SOMNIOSUS_MICROCEPHALUS	HIPPOGLOSSOIDES_PLATESSOIDES	1
SOM_MIC-HYA_SP	SOMNIOSUS_MICROCEPHALUS	HYAS_SP	1
SOM_MIC-LEP_DEC	SOMNIOSUS_MICROCEPHALUS	LEPTAGONUS_DECAGONUS	1
SOM_MIC-LIM_LIM	SOMNIOSUS_MICROCEPHALUS	LIMANDA_LIMANDA	1
SOM_MIC-LIP_FAB	SOMNIOSUS_MICROCEPHALUS	LIPARIS_FABRICII	4
SOM_MIC-LIP_GIB	SOMNIOSUS_MICROCEPHALUS	LIPARIS_GIBBUS	4
SOM_MIC-LIP_MON	SOMNIOSUS_MICROCEPHALUS	LIPARIS_MONTAGUI	4
SOM_MIC-LYC_EUD	SOMNIOSUS_MICROCEPHALUS	LYCODES_EUDIPLEUROSTICTUS	1
SOM_MIC-MAL_VIL	SOMNIOSUS_MICROCEPHALUS	MALLOTUS_VILLOSUS	2
SOM_MIC-MEL_AEG	SOMNIOSUS_MICROCEPHALUS	MELANOGRAMMUS_AEGLEFINUS	1
SOM_MIC-MER_OVU	SOMNIOSUS_MICROCEPHALUS	MERTENSIA_OVUM	1
SOM_MIC-MOL_MOL	SOMNIOSUS_MICROCEPHALUS	MOLVA_MOLVA	1
SOM_MIC-OPH_ACU	SOMNIOSUS_MICROCEPHALUS	OPHIOPHOLIS_ACULEATA	1
SOM_MIC-OPH_SP	SOMNIOSUS_MICROCEPHALUS	OPHIURA_SP	1
SOM_MIC-PAN_BOR	SOMNIOSUS_MICROCEPHALUS	PANDALUS_BOREALIS	1
SOM_MIC-PAR_BAT	SOMNIOSUS_MICROCEPHALUS	PARALIPARIS_BATHYBIUS	4
SOM_MIC-PHO_HIS	SOMNIOSUS_MICROCEPHALUS	PHOCA_HISPIDA	4
SOM_MIC-PLE_PLA	SOMNIOSUS_MICROCEPHALUS	PLEURONECTES_PLATESSA	1
SOM_MIC-POL_IND	SOMNIOSUS_MICROCEPHALUS	POLYCHAETA	1
SOM_MIC-POL_VIR	SOMNIOSUS_MICROCEPHALUS	POLLACHIUS_VIRENS	1
SOM_MIC-REI_HIP	SOMNIOSUS_MICROCEPHALUS	REINHARDTIUS_HIPPOGLOSSOIDES	1
SOM_MIC-SEB_MAR	SOMNIOSUS_MICROCEPHALUS	SEBASTES_MARINUS	1
SOM_MIC-SEB_MEN	SOMNIOSUS_MICROCEPHALUS	SEBASTES_MENTELLA	1
SOM_MIC-SOM_MIC	SOMNIOSUS_MICROCEPHALUS	SOMNIOSUS_MICROCEPHALUS	1
SOM_MIC-SQU_ACA	SOMNIOSUS_MICROCEPHALUS	SQUALUS_ACANTHIAS	2
SOM_MIC-STRO_SP	SOMNIOSUS_MICROCEPHALUS	STRONGYLOCENTROTUS_SP	1
SOM_MIC-TRI_NYB	SOMNIOSUS_MICROCEPHALUS	TRIGLOPS_NYBELINI	1
SOM_MIC-URS_MAR	SOMNIOSUS_MICROCEPHALUS	URSUS_MARITIMUS	1
SPI_IND-DET_IND	SPIRORBIDAE_INDET	DETRITUS	4
SPI_IND-PHY_IND	SPIRORBIDAE_INDET	PHYTOPLANKTON_INDET	3
SPI_KRO-DET_IND	SPIOPHANES_KROEYERI	DETRITUS	4
SPI_KRO-PHY_IND	SPIOPHANES_KROEYERI	PHYTOPLANKTON_INDET	3
SPI_TYP-DET_IND	SPIOCHAETOPTERUS_TYPICUS	DETRITUS	4
SPI_TYP-PHY_IND	SPIOCHAETOPTERUS_TYPICUS	PHYTOPLANKTON_INDET	3
SQU_ACA-AMM_SPP	SQUALUS_ACANTHIAS	AMMODYTES_SPP	2
SQU_ACA-ANA_DEN	SQUALUS_ACANTHIAS	ANARHICHAS_DENTICULATUS	2
SQU_ACA-ANA_LUP	SQUALUS_ACANTHIAS	ANARHICHAS_LUPUS	2
SQU_ACA-ANA_MIN	SQUALUS_ACANTHIAS	ANARHICHAS_MINOR	2
SQU_ACA-AUR_AUR	SQUALUS_ACANTHIAS	AURELIA_AURITA	1
SQU_ACA-BOL_INF	SQUALUS_ACANTHIAS	BOLINOPSIS_INFUNDIBULUM	2
SQU_ACA-CLU_HAR	SQUALUS_ACANTHIAS	CLUPEA_HARENGUS	2
SQU_ACA-EUP_FLAM	SQUALUS_ACANTHIAS	EUPHYSA_FLAMMEA	2
SQU_ACA-GAD_MOR	SQUALUS_ACANTHIAS	GADUS_MORHUA	2
SQU_ACA-GON_FAB	SQUALUS_ACANTHIAS	GONATUS_FABRICII	4
SQU_ACA-LIM_LIM	SQUALUS_ACANTHIAS	LIMANDA_LIMANDA	2
SQU_ACA-MEL_AEG	SQUALUS_ACANTHIAS	MELANOGRAMMUS_AEGLEFINUS	2
SQU_ACA-MER_OVU	SQUALUS_ACANTHIAS	MERTENSIA_OVUM	2
SQU_ACA-PLE_PLA	SQUALUS_ACANTHIAS	PLEURONECTES_PLATESSA	2
SQU_ACA-REI_HIP	SQUALUS_ACANTHIAS	REINHARDTIUS_HIPPOGLOSSOIDES	2
STI_TRE-AUT_FLA	STICHOPUS_TREMULUS	AUTOTHROPH_FLAGELLAT	1
STI_TRE-DET_IND	STICHOPUS_TREMULUS	DETRITUS	1
STI_TRE-DIATOM	STICHOPUS_TREMULUS	DIATOM	1
STI_TRE-FOR_IND	STICHOPUS_TREMULUS	FORAMINIFERA	1
STI_TRE-HET_FLA	STICHOPUS_TREMULUS	HETEROTROPH_FLAGELLAT	1
STRO_SP-MAC_IND	STRONGYLOCENTROTUS_SP	MACROALGAE	1
TER_STRO-AUT_FLA	TEREBELLIDES_STROEMI	AUTOTHROPH_FLAGELLAT	1
TER_STRO-DIATOM	TEREBELLIDES_STROEMI	DIATOM	1
TER_STRO-HET_FLA	TEREBELLIDES_STROEMI	HETEROTROPH_FLAGELLAT	1
TER_STRO-PHY_IND	TEREBELLIDES_STROEMI	PHYTOPLANKTON_INDET	3
THE_ABY-CAL_FIN	THEMISTO_ABYSSORUM	CALANUS_FINMARCHICUS	1
THE_ABY-CAL_GLA	THEMISTO_ABYSSORUM	CALANUS_GLACIALIS	2
THE_ABY-CAL_HYP	THEMISTO_ABYSSORUM	CALANUS_HYPERBOREUS	2
THE_ABY-MET_LON	THEMISTO_ABYSSORUM	METRIDIA_LONGA	2
THE_ABY-MIC_SPP	THEMISTO_ABYSSORUM	MICROCALANUS_SPP	2
THE_ABY-OIK_VAN	THEMISTO_ABYSSORUM	OIKOPLEURA_VANHOEFFENI	4
THE_ABY-OIT_SIM	THEMISTO_ABYSSORUM	OITHONA_SPINIROSTRIS/ATLANTICA	2
THE_ABY-PHY_IND	THEMISTO_ABYSSORUM	PHYTOPLANKTON_INDET	3
THE_LIB-CAL_FIN	THEMISTO_LIBELLULA	CALANUS_FINMARCHICUS	1
THE_LIB-CAL_GLA	THEMISTO_LIBELLULA	CALANUS_GLACIALIS	2
THE_LIB-CAL_HYP	THEMISTO_LIBELLULA	CALANUS_HYPERBOREUS	1
THE_LIB-MET_LON	THEMISTO_LIBELLULA	METRIDIA_LONGA	2
THE_LIB-MIC_SPP	THEMISTO_LIBELLULA	MICROCALANUS_SPP	2
THE_LIB-OIT_SIM	THEMISTO_LIBELLULA	OITHONA_SPINIROSTRIS/ATLANTICA	2
THY_GOU-DIATOM	THYASIRA_GOULDI	DIATOM	4
THY_INE-AUT_FLA	THYSANOESSA_INERMIS	AUTOTHROPH_FLAGELLAT	1
THY_INE-BEN_LAR	THYSANOESSA_INERMIS	BENTHOS_LARVAE	1
THY_INE-CAL_FIN	THYSANOESSA_INERMIS	CALANUS_FINMARCHICUS	1
THY_INE-CAL_GLA	THYSANOESSA_INERMIS	CALANUS_GLACIALIS	4
THY_INE-CAL_HYP	THYSANOESSA_INERMIS	CALANUS_HYPERBOREUS	4
THY_INE-HET_FLA	THYSANOESSA_INERMIS	HETEROTROPH_FLAGELLAT	1
THY_LON-AUT_FLA	THYSANOESSA_LONGICAUDATA	AUTOTHROPH_FLAGELLAT	1
THY_LON-CAL_FIN	THYSANOESSA_LONGICAUDATA	CALANUS_FINMARCHICUS	1
THY_LON-CAL_GLA	THYSANOESSA_LONGICAUDATA	CALANUS_GLACIALIS	4
THY_LON-CAL_HYP	THYSANOESSA_LONGICAUDATA	CALANUS_HYPERBOREUS	4
THY_LON-FI_LA	THYSANOESSA_LONGICAUDATA	FISH_LARVAE	1
THY_LON-HET_FLA	THYSANOESSA_LONGICAUDATA	HETEROTROPH_FLAGELLAT	1
THY_RAS-APH_GLA	THYSANOESSA_RASCHII	APHERUSA_GLACIALIS	4
THY_RAS-AUT_FLA	THYSANOESSA_RASCHII	AUTOTHROPH_FLAGELLAT	1
THY_RAS-CAL_FIN	THYSANOESSA_RASCHII	CALANUS_FINMARCHICUS	1
THY_RAS-CAL_GLA	THYSANOESSA_RASCHII	CALANUS_GLACIALIS	4
THY_RAS-CAL_HYP	THYSANOESSA_RASCHII	CALANUS_HYPERBOREUS	4
THY_RAS-FI_LA	THYSANOESSA_RASCHII	FISH_LARVAE	1
THY_RAS-HET_FLA	THYSANOESSA_RASCHII	HETEROTROPH_FLAGELLAT	1
THY_RAS-THY_RAS	THYSANOESSA_RASCHII	THYSANOESSA_RASCHII	1
TRI_ESM-APH_GLA	TRISOPTERUS_ESMARKII	APHERUSA_GLACIALIS	2
TRI_ESM-CAL_FIN	TRISOPTERUS_ESMARKII	CALANUS_FINMARCHICUS	1
TRI_ESM-CAL_GLA	TRISOPTERUS_ESMARKII	CALANUS_GLACIALIS	2
TRI_ESM-CAL_HYP	TRISOPTERUS_ESMARKII	CALANUS_HYPERBOREUS	2
TRI_ESM-ERY_SP	TRISOPTERUS_ESMARKII	ERYTHROPS_SP	1
TRI_ESM-EUK_HAM	TRISOPTERUS_ESMARKII	EUKROHNIA_HAMATA	1
TRI_ESM-GAM_IND	TRISOPTERUS_ESMARKII	GAMMARIDAE_INDET	1
TRI_ESM-GAM_WIL	TRISOPTERUS_ESMARKII	GAMMARUS_WILKITZKII	2
TRI_ESM-LUM_SP	TRISOPTERUS_ESMARKII	LUMBRINERIS_SP	1
TRI_ESM-MEG_NOR	TRISOPTERUS_ESMARKII	MEGANYCTIPHANES_NORVEGICA	1
TRI_ESM-MET_LON	TRISOPTERUS_ESMARKII	METRIDIA_LONGA	1
TRI_ESM-OIT_SIM	TRISOPTERUS_ESMARKII	OITHONA_SPINIROSTRIS/ATLANTICA	2
TRI_ESM-ONI_GLA	TRISOPTERUS_ESMARKII	ONISIMUS_GLACIALIS	2
TRI_ESM-ONI_NAN	TRISOPTERUS_ESMARKII	ONISIMUS_NANSENI	2
TRI_ESM-OPH_ACU	TRISOPTERUS_ESMARKII	OPHIOPHOLIS_ACULEATA	3
TRI_ESM-OST_IND	TRISOPTERUS_ESMARKII	OSTRACODA_INDET	1
TRI_ESM-PAN_BOR	TRISOPTERUS_ESMARKII	PANDALUS_BOREALIS	1
TRI_ESM-PAR_NOR	TRISOPTERUS_ESMARKII	PAREUCHAETA_NORVEGICA	1
TRI_ESM-PON_NOR	TRISOPTERUS_ESMARKII	PONTOPHILUS_NORVEGICUS	1
TRI_ESM-PSE_SPP	TRISOPTERUS_ESMARKII	PSEUDOCALANUS_SPP	2
TRI_ESM-ROS_SP	TRISOPTERUS_ESMARKII	ROSSIA_SP	1
TRI_ESM-SAG_SPP	TRISOPTERUS_ESMARKII	SAGITTA_SPP	1
TRI_ESM-STRO_SP	TRISOPTERUS_ESMARKII	STRONGYLOCENTROTUS_SP	3
TRI_ESM-THE_ABY	TRISOPTERUS_ESMARKII	THEMISTO_ABYSSORUM	1
TRI_ESM-THY_INE	TRISOPTERUS_ESMARKII	THYSANOESSA_INERMIS	1
TRI_ESM-THY_RAS	TRISOPTERUS_ESMARKII	THYSANOESSA_RASCHII	1
TRI_MUR-CAL_FIN	TRIGLOPS_MURRAYI	CALANUS_FINMARCHICUS	1
TRI_MUR-CAL_GLA	TRIGLOPS_MURRAYI	CALANUS_GLACIALIS	1
TRI_MUR-CAL_HYP	TRIGLOPS_MURRAYI	CALANUS_HYPERBOREUS	2
TRI_MUR-MAL_VIL	TRIGLOPS_MURRAYI	MALLOTUS_VILLOSUS	1
TRI_MUR-PAN_BOR	TRIGLOPS_MURRAYI	PANDALUS_BOREALIS	4
TRI_MUR-THE_LIB	TRIGLOPS_MURRAYI	THEMISTO_LIBELLULA	4
TRI_MUR-THY_INE	TRIGLOPS_MURRAYI	THYSANOESSA_INERMIS	1
TRI_NYB-CAL_HYP	TRIGLOPS_NYBELINI	CALANUS_HYPERBOREUS	1
TRI_NYB-POL_IND	TRIGLOPS_NYBELINI	POLYCHAETA	1
TRI_NYB-THE_ABY	TRIGLOPS_NYBELINI	THEMISTO_ABYSSORUM	1
TRI_NYB-THE_LIB	TRIGLOPS_NYBELINI	THEMISTO_LIBELLULA	1
TRI_PIN-ASC_G_SP	TRIGLOPS_PINGELII	ASCIDIACEA_G_SP	1
TRI_PIN-CAL_GLA	TRIGLOPS_PINGELII	CALANUS_GLACIALIS	1
TRI_PIN-CAL_HYP	TRIGLOPS_PINGELII	CALANUS_HYPERBOREUS	1
TRI_PIN-LIM_HEL	TRIGLOPS_PINGELII	LIMACINA_HELICINA	1
TRI_PIN-POL_IND	TRIGLOPS_PINGELII	POLYCHAETA	1
TRI_PIN-POLY_IND	TRIGLOPS_PINGELII	POLYNOIDAE_INDET	2
TRI_PIN-SAG_SPP	TRIGLOPS_PINGELII	SAGITTA_SPP	1
TRI_PIN-THE_LIB	TRIGLOPS_PINGELII	THEMISTO_LIBELLULA	1
TRI_PIN-THY_INE	TRIGLOPS_PINGELII	THYSANOESSA_INERMIS	1
ULC_OLR-GAM_IND	ULCINA_OLRIKII	GAMMARIDAE_INDET	1
ULC_OLR-MAC_SP	ULCINA_OLRIKII	MACOMA_SP	1
ULC_OLR-OST_IND	ULCINA_OLRIKII	OSTRACODA_INDET	1
URA_LIN-DET_IND	URASTERIAS_LINCKII	DETRITUS	2
URI_AAL-AMM_SPP	URIA_AALGE	AMMODYTES_SPP	1
URI_AAL-CLU_HAR	URIA_AALGE	CLUPEA_HARENGUS	1
URI_AAL-GAD_MOR	URIA_AALGE	GADUS_MORHUA	1
URI_AAL-GON_FAB	URIA_AALGE	GONATUS_FABRICII	1
URI_AAL-MAL_VIL	URIA_AALGE	MALLOTUS_VILLOSUS	1
URI_AAL-MEL_AEG	URIA_AALGE	MELANOGRAMMUS_AEGLEFINUS	1
URI_AAL-POL_VIR	URIA_AALGE	POLLACHIUS_VIRENS	1
URI_LOM-AMM_SPP	URIA_LOMVIA	AMMODYTES_SPP	1
URI_LOM-BOR_SAI	URIA_LOMVIA	BOREOGADUS_SAIDA	1
URI_LOM-MAL_VIL	URIA_LOMVIA	MALLOTUS_VILLOSUS	1
URI_LOM-SEB_SPP	URIA_LOMVIA	SEBASTES_SPP	1
URS_MAR-DEL_LEU	URSUS_MARITIMUS	DELPHINAPTERUS_LEUCAS	1
URS_MAR-ERI_BAR	URSUS_MARITIMUS	ERIGNATHUS_BARBATUS	1
URS_MAR-ODO_ROS	URSUS_MARITIMUS	ODOBENUS_ROSMARUS	1
URS_MAR-PAG_GRO	URSUS_MARITIMUS	PAGOPHILUS_GROENLANDICUS	1
URS_MAR-PHO_HIS	URSUS_MARITIMUS	PHOCA_HISPIDA	1
YOL_SOL-DET_IND	YOLDIELLA_SOLIDULA	DETRITUS	4
